cell	celltype
AAACCCAAGGAGAGTA-1	Monocyte
AAACGCTTCAGCCCAG-1	B cell
AAAGAACAGACGACTG-1	CD8 T cell
AAAGAACCAATGGCAG-1	CD8 T cell
AAAGAACGTCTGCAAT-1	CD4 T cell
AAAGGATAGTAGACAT-1	B cell
AAAGGATCACCGGCTA-1	B cell
AAAGGATTCAGCTTGA-1	Monocyte
AAAGGATTCCGTTTCG-1	Monocyte
AAAGGGCTCATGCCCT-1	CD8 T cell
AAAGGGCTCCGTAGGC-1	CD8 T cell
AAAGGTACAACTGCTA-1	Monocyte
AAAGTCCAGCGGGTTA-1	CD8 T cell
AAAGTCCCACCAGCCA-1	B cell
AAAGTGATCGTACACA-1	NK cell
AAATGGAAGCCGCTTG-1	Monocyte
AAATGGACAATGCTCA-1	Monocyte
AAATGGATCCTATTTG-1	B cell
AACAAAGGTGATGAAT-1	CD4 T cell
AACAACCAGTAGTCCT-1	Monocyte
AACAACCCACGCTATA-1	CD8 T cell
AACAAGAGTTATAGAG-1	Monocyte
AACAGGGGTGGGAGAG-1	CD8 T cell
AACCAACAGCTTGTTG-1	CD4 T cell
AACCCAACAACTGATC-1	CD8 T cell
AACCCAAGTGGGCTTC-1	B cell
AACCCAATCTTACCGC-1	NK cell
AACCTGACATCCTATT-1	Monocyte
AACCTTTGTTTCGGCG-1	NK cell
AACGAAAAGGTTGGTG-1	Monocyte
AACGAAACAGCGTTTA-1	Monocyte
AACGAAATCCATTTAC-1	CD4 T cell
AACGGGAGTCGCTCGA-1	Monocyte
AACGTCAAGACGCCCT-1	Monocyte
AAGAACAAGACCATTC-1	CD8 T cell
AAGAACAAGCCTCAGC-1	Monocyte
AAGAACATCTTGCAAG-1	CD8 T cell
AAGACAACACTTCAGA-1	Monocyte
AAGACAATCCGCGAGT-1	CD8 T cell
AAGCATCAGGTCCGAA-1	CD4 T cell
AAGCATCCAGTCTTCC-1	Monocyte
AAGCGTTCACTGATTG-1	Monocyte
AAGCGTTTCGCTATTT-1	B cell
AAGGTAAAGGAAGTAG-1	CD8 T cell
AAGGTAAAGGCCACCT-1	CD4 T cell
AAGGTAAGTCCTTAAG-1	CD4 T cell
AAGTACCAGCGCCTTG-1	CD4 T cell
AAGTACCAGCTCCATA-1	CD4 T cell
AAGTACCCAAAGAACT-1	CD4 T cell
AAGTGAACATCAGCAT-1	CD8 T cell
AAGTGAATCGGAAGGT-1	Monocyte
AAGTTCGAGGATACAT-1	CD8 T cell
AAGTTCGGTCAACACT-1	Monocyte
AATCGACGTGAGACGT-1	Monocyte
AATGGAACACTCATAG-1	B cell
AATGGAATCTGATGGT-1	Monocyte
AATTCCTTCCATTGGA-1	Monocyte
ACAAAGAAGCCTCAAT-1	Monocyte
ACAAAGAGTTCCATTT-1	CD4 T cell
ACAACCATCTATCCAT-1	CD4 T cell
ACAACCATCTGCCCTA-1	CD4 T cell
ACAAGCTGTAGGTCAG-1	CD4 T cell
ACACCAAAGAGTCAGC-1	CD4 T cell
ACACGCGGTGTTGCCG-1	Monocyte
ACACGCGTCACCTCGT-1	NK cell
ACACGCGTCGCCGTGA-1	Monocyte
ACACTGATCACTGATG-1	Monocyte
ACACTGATCTTTCCGG-1	CD4 T cell
ACAGAAAAGTATTAGG-1	Monocyte
ACAGAAACACCAGCGT-1	Monocyte
ACAGCCGTCGCTGTTC-1	B cell
ACATCCCCACAAATGA-1	CD8 T cell
ACATCCCGTAAGATTG-1	Monocyte
ACATCGATCTAAGAAG-1	NK cell
ACATCGATCTGAGAGG-1	CD8 T cell
ACATCGATCTTGGGCG-1	Monocyte
ACATGCAGTTGCTTGA-1	Monocyte
ACATTTCGTGCCGAAA-1	CD4 T cell
ACATTTCGTTTCTTAC-1	B cell
ACCACAAAGGCCTTGC-1	Monocyte
ACCACAAGTCTGTGGC-1	B cell
ACCATTTCATTGGGAG-1	CD4 T cell
ACCCAAAGTTGGGAAC-1	Dendritic cell
ACCCTTGGTATCGTAC-1	CD4 T cell
ACCCTTGTCATTTCGT-1	CD8 T cell
ACCTACCCAACGGTAG-1	CD8 T cell
ACCTGAACATGAGAAT-1	CD4 T cell
ACCTGTCTCAAGTCTG-1	CD4 T cell
ACCTGTCTCTCAACGA-1	Monocyte
ACGATCAGTCGTTCAA-1	CD8 T cell
ACGATCATCCACGGAC-1	CD8 T cell
ACGATCATCCGTTGGG-1	CD8 T cell
ACGCACGAGAGAGTGA-1	NK cell
ACGGTCGTCACTACGA-1	CD4 T cell
ACGGTTAAGTGCTCAT-1	B cell
ACGTAACAGGTGCTTT-1	CD4 T cell
ACGTAACTCATATGGC-1	B cell
ACGTAACTCTTCGATT-1	Monocyte
ACGTACAAGCTGTTCA-1	CD8 T cell
ACGTACACAAAGCTCT-1	Monocyte
ACGTACACAGACGATG-1	NK cell
ACGTAGTCACGCCACA-1	B cell
ACGTAGTCATTAGGAA-1	CD8 T cell
ACGTTCCGTGGGTCAA-1	Monocyte
ACTATCTGTGTGTACT-1	NK cell
ACTATGGAGAAATCCA-1	B cell
ACTCCCAAGGTTGGTG-1	NK cell
ACTCCCATCGTCCTCA-1	CD4 T cell
ACTGATGAGCAGCGAT-1	B cell
ACTGATGCACCAGCCA-1	B cell
ACTGTGACAACTCGAT-1	CD8 T cell
ACTTATCTCTAAGGAA-1	Monocyte
ACTTCGCAGAACCGCA-1	CD4 T cell
ACTTCGCGTACTCCGG-1	B cell
ACTTTCAAGTATGACA-1	CD8 T cell
ACTTTCAGTACGCGTC-1	CD4 T cell
AGAAGCGGTCTAGATC-1	CD4 T cell
AGAAGCGTCTGCGTCT-1	CD4 T cell
AGACAAAGTAGCTTGT-1	Monocyte
AGACACTCAAGTCGTT-1	CD4 T cell
AGACCATCATTACTCT-1	CD8 T cell
AGACTCATCAACGCTA-1	CD4 T cell
AGACTCATCAGAGCGA-1	Monocyte
AGAGAATAGAGGGTCT-1	CD8 T cell
AGAGAATCACCCAACG-1	CD8 T cell
AGAGAGCAGTTGTCGT-1	B cell
AGAGCAGGTCATAAAG-1	Monocyte
AGAGCAGGTTGAGTCT-1	CD4 T cell
AGAGCAGTCGCGCTGA-1	CD8 T cell
AGAGCCCGTCACTCGG-1	CD4 T cell
AGATAGAGTGACACGA-1	Monocyte
AGATCGTCAGGACTTT-1	CD8 T cell
AGATGAACAGGCACAA-1	CD4 T cell
AGATGCTGTACGGTTT-1	Monocyte
AGATGCTGTGTGGTCC-1	CD4 T cell
AGCATCAGTCGGTGTC-1	Monocyte
AGCATCAGTGGTCCGT-1	CD4 T cell
AGCCAATAGTCCCTAA-1	CD4 T cell
AGCCACGCAGGTTCGC-1	CD4 T cell
AGCCACGGTTCCGCGA-1	Monocyte
AGCCACGTCCGAGAAG-1	CD8 T cell
AGCCAGCGTAATGCGG-1	CD4 T cell
AGCCAGCGTAGTTAGA-1	Dendritic cell
AGCGTATTCAGTGGGA-1	B cell
AGCGTCGCATTGACCA-1	CD4 T cell
AGCTACACAGTCGGAA-1	CD4 T cell
AGCTACAGTCGTTTCC-1	CD8 T cell
AGGAAATTCACCATGA-1	Monocyte
AGGAATACAAACTCGT-1	CD8 T cell
AGGAATATCATTACGG-1	CD4 T cell
AGGACGAAGACCTTTG-1	NK cell
AGGACGAAGATTAGTG-1	CD4 T cell
AGGACGATCACTGATG-1	CD8 T cell
AGGACGATCCAGTACA-1	CD8 T cell
AGGACTTTCCTACCAC-1	CD8 T cell
AGGATAAAGAACAAGG-1	CD4 T cell
AGGCCACAGGGCCAAT-1	B cell
AGGCTGCAGGGCTTCC-1	B cell
AGGCTGCGTGTGTGTT-1	B cell
AGGGAGTGTGTCGCTG-1	CD4 T cell
AGGGCTCCAATACGCT-1	Monocyte
AGGGTCCCAGGACATG-1	Monocyte
AGGGTCCCAGTAGTTC-1	CD8 T cell
AGGGTTTCAGCGTGCT-1	Monocyte
AGGTAGGAGGAAGTAG-1	B cell
AGGTAGGCAAAGCGTG-1	Monocyte
AGGTCATTCAAGTCGT-1	Monocyte
AGGTGTTCATTAAGCC-1	Monocyte
AGGTGTTGTCGATTAC-1	CD4 T cell
AGGTGTTTCAATGCAC-1	CD4 T cell
AGGTTACAGGTGCGAT-1	CD8 T cell
AGGTTACGTCTGATAC-1	Monocyte
AGTAACCCAAGCTCTA-1	Monocyte
AGTAACCTCGTTGTAG-1	CD4 T cell
AGTACCAGTGGGTCAA-1	Monocyte
AGTACCATCAGCTTGA-1	NK cell
AGTAGCTAGGAGTACC-1	B cell
AGTAGCTCAGGCACTC-1	Monocyte
AGTAGCTGTTAGAAAC-1	Monocyte
AGTAGTCGTATGACAA-1	CD4 T cell
AGTCAACAGTCATGCT-1	Monocyte
AGTCAACGTACACGCC-1	Dendritic cell
AGTCTCCCAACCGTGC-1	B cell
AGTCTCCGTGAGTCAG-1	CD8 T cell
AGTGCCGCATCTGGGC-1	CD8 T cell
AGTTAGCAGTCAGGGT-1	CD8 T cell
AGTTAGCGTACCATAC-1	B cell
AGTTAGCGTTCATCGA-1	CD8 T cell
AGTTCCCCAAACAGGC-1	CD8 T cell
AGTTCCCGTTACACTG-1	CD4 T cell
AGTTCGAGTATGCGTT-1	B cell
ATACCGACACACGGTC-1	CD4 T cell
ATACTTCGTACGACTT-1	Monocyte
ATACTTCGTTCGGTAT-1	CD4 T cell
ATACTTCTCAGCTGAT-1	CD4 T cell
ATACTTCTCGCCGTGA-1	B cell
ATAGACCTCCGCTTAC-1	NK cell
ATAGGCTGTGTTACAC-1	Monocyte
ATATCCTGTATGAGCG-1	B cell
ATCACAGAGACGTCCC-1	Monocyte
ATCACAGCATGACGTT-1	Monocyte
ATCACGATCCGCAACG-1	CD8 T cell
ATCACTTGTGGCTGCT-1	Monocyte
ATCCACCCAGCAGTGA-1	NK cell
ATCCACCCATGTCTAG-1	NK cell
ATCCACCGTTTGTTGG-1	Monocyte
ATCCATTAGACGCAGT-1	B cell
ATCCCTGCAATTTCTC-1	CD8 T cell
ATCCGTCCAACTCCCT-1	B cell
ATCCTATGTCTGTGCG-1	B cell
ATCGATGCAACGGCTC-1	B cell
ATCGATGGTCAATCTG-1	NK cell
ATCGGATAGGAAAGGT-1	CD4 T cell
ATCGTAGCATCGGAGA-1	Monocyte
ATCGTCCAGCCTGAAG-1	Monocyte
ATCGTCCGTATGAGGC-1	Monocyte
ATCGTCCTCGGAGCAA-1	Monocyte
ATCGTGAAGCAGATAT-1	Monocyte
ATCTCTACAAGAAACT-1	Monocyte
ATCTTCAAGAAGAGCA-1	Monocyte
ATCTTCACATACTGAC-1	Monocyte
ATCTTCAGTCTCTCCA-1	Monocyte
ATCTTCATCTCATAGG-1	CD8 T cell
ATGAAAGTCCTTATGT-1	CD4 T cell
ATGACCAAGGCTAACG-1	Monocyte
ATGACCACAATATCCG-1	CD4 T cell
ATGAGTCTCCAGTTCC-1	B cell
ATGATCGGTCGAACAG-1	B cell
ATGCGATGTGCTCTTC-1	B cell
ATGCGATGTTGTAGCT-1	CD4 T cell
ATGGATCGTAGATTGA-1	B cell
ATGGATCTCGACCTAA-1	CD4 T cell
ATGGGAGAGACGTCCC-1	CD4 T cell
ATGGGAGTCCACTGAA-1	Monocyte
ATGGTTGTCACGGAGA-1	Monocyte
ATGTCCCCAGGAATCG-1	B cell
ATGTCCCCATAGGTTC-1	B cell
ATGTCCCGTCCTACGG-1	Monocyte
ATTACTCCAGCTTTGA-1	CD4 T cell
ATTACTCGTTGCAACT-1	B cell
ATTCACTAGAAGGCTC-1	CD8 T cell
ATTCACTTCTCCGCAT-1	NK cell
ATTCAGGCAAGTATCC-1	Monocyte
ATTCAGGCATAGCTGT-1	Monocyte
ATTCAGGTCTTCGTGC-1	CD4 T cell
ATTCCCGAGTCACTCA-1	CD4 T cell
ATTCCTACATGAGATA-1	Monocyte
ATTCGTTCAGTCTTCC-1	CD4 T cell
ATTCGTTGTAACACCT-1	CD4 T cell
ATTCGTTGTGTAGCAG-1	B cell
ATTCGTTGTGTTCAGT-1	CD4 T cell
ATTCGTTGTTCTTGTT-1	Monocyte
ATTCTACTCTCGTGAA-1	CD8 T cell
ATTCTTGGTACAATAG-1	CD8 T cell
ATTTCACAGTGCAAAT-1	Monocyte
ATTTCACGTGGATACG-1	Monocyte
ATTTCTGCAAGGTCTT-1	Monocyte
ATTTCTGGTATCCTCC-1	B cell
ATTTCTGTCGATGCAT-1	Monocyte
ATTTCTGTCGGCCAAC-1	CD4 T cell
CAAAGAACACATATCG-1	CD4 T cell
CAAAGAACAGCTGTTA-1	CD8 T cell
CAAAGAAGTTCTCCCA-1	Monocyte
CAACAACTCGATACTG-1	CD8 T cell
CAACAGTCATCCGTTC-1	CD4 T cell
CAACAGTTCGAGCACC-1	CD4 T cell
CAACCAAGTTAGAAAC-1	Monocyte
CAACCTCGTATCGGTT-1	CD4 T cell
CAACGATAGACGGAAA-1	Monocyte
CAACGATAGCCTAGGA-1	Monocyte
CAACGATCAAAGCACG-1	CD4 T cell
CAACGATTCAAGCCCG-1	Monocyte
CAAGACTAGTGGAAAG-1	CD8 T cell
CAAGACTTCAATCGGT-1	Monocyte
CAAGAGGTCTTCACGC-1	Monocyte
CAAGGGAAGAGTCGAC-1	CD4 T cell
CAATACGAGGCAGCTA-1	CD8 T cell
CAATCGAAGAGGATCC-1	CD4 T cell
CAATCGATCCGTACGG-1	CD4 T cell
CAATGACTCAAGCCCG-1	CD4 T cell
CAATTTCAGATTGCGG-1	B cell
CACACAACAAGAAACT-1	CD4 T cell
CACACAACACGAGGAT-1	Monocyte
CACAGATCACTCCGAG-1	Monocyte
CACAGATCATCATGAC-1	Monocyte
CACAGATGTTCCGTTC-1	Monocyte
CACAGGCCAACGATCT-1	Monocyte
CACATGAGTTTCGACA-1	CD4 T cell
CACCAAAAGGACATCG-1	Monocyte
CACCGTTCACCCTAGG-1	CD4 T cell
CACGAATCACATAGCT-1	CD4 T cell
CACGAATTCAAGTCGT-1	CD4 T cell
CACGGGTAGCATTTGC-1	Monocyte
CACGGGTTCCCGATCT-1	B cell
CACGTTCCAGCTTCCT-1	Monocyte
CACGTTCTCTATCACT-1	CD4 T cell
CACTAAGGTGATAGTA-1	CD4 T cell
CACTGAAGTCTTTCTA-1	B cell
CACTGGGAGGCGACAT-1	Monocyte
CACTGGGAGTTACTCG-1	Monocyte
CACTGGGGTCGCACAC-1	Monocyte
CACTGTCCACATATGC-1	B cell
CAGAGCCGTGCCCGTA-1	CD4 T cell
CAGATACTCGTTCCCA-1	CD4 T cell
CAGATTGAGCTGAGCA-1	CD4 T cell
CAGATTGGTGACTAAA-1	B cell
CAGCAATGTATCGTTG-1	Monocyte
CAGCAGCTCAGAGTTC-1	CD8 T cell
CAGCCAGGTGGGTTGA-1	Monocyte
CAGCGTGTCCATCACC-1	B cell
CAGGCCAGTTCAATCG-1	CD4 T cell
CAGGCCATCACTCACC-1	CD8 T cell
CAGGCCATCCACTAGA-1	Monocyte
CAGGGCTAGATTGGGC-1	CD8 T cell
CAGGGCTTCGACGAGA-1	B cell
CAGGTATGTCAGTCTA-1	Dendritic cell
CAGGTATGTGTAAATG-1	B cell
CAGTTCCCAATCGTCA-1	CD8 T cell
CATAAGCGTAGCGCTC-1	CD4 T cell
CATAAGCTCCGTGTGG-1	Monocyte
CATACTTTCAACGAGG-1	CD4 T cell
CATCAAGGTATGGTTC-1	B cell
CATCAAGGTTGTCCCT-1	B cell
CATCCGTGTATCGCTA-1	CD8 T cell
CATCGGGTCGCTACAA-1	B cell
CATCGTCTCCGTTGAA-1	CD8 T cell
CATGAGTCACCATTCC-1	CD8 T cell
CATGCCTCAATTGCTG-1	B cell
CATGCCTGTTCCGCAG-1	Monocyte
CATTCTAGTAGCTTGT-1	CD8 T cell
CATTCTATCAGTAGGG-1	Monocyte
CATTGAGAGGGACCAT-1	Monocyte
CATTTCATCTCTCTTC-1	Monocyte
CCAAGCGAGCTAATCC-1	CD4 T cell
CCAAGCGAGGTTCATC-1	Monocyte
CCAATGAAGGTCACTT-1	B cell
CCAATTTCAAAGGCTG-1	CD8 T cell
CCAATTTCATTCGATG-1	CD8 T cell
CCACACTCAGGACTTT-1	Monocyte
CCACCATAGGTCATCT-1	CD8 T cell
CCACGAGTCTTCCTAA-1	Monocyte
CCACGTTTCATCAGTG-1	B cell
CCACGTTTCGTGAGAG-1	CD4 T cell
CCACGTTTCTGCTGAA-1	B cell
CCACTTGTCGCAGAGA-1	Monocyte
CCATAAGGTGAGGAAA-1	Monocyte
CCATCACCATTAAAGG-1	B cell
CCATCACTCTAACACG-1	Monocyte
CCCGGAATCAAACCCA-1	CD4 T cell
CCCTAACCAGGTTCGC-1	CD4 T cell
CCCTAACGTAACTGCT-1	Monocyte
CCCTTAGGTTTCCAAG-1	CD4 T cell
CCGAACGAGCTAAGTA-1	CD4 T cell
CCGAACGAGGAACGCT-1	Monocyte
CCGATCTGTGGAGGTT-1	Monocyte
CCGATGGTCTGTCGCT-1	B cell
CCGCAAGCATTCAGGT-1	CD8 T cell
CCGCAAGGTACCAGAG-1	CD4 T cell
CCGGACAGTGATACCT-1	Monocyte
CCGGGTACACTCCGAG-1	Monocyte
CCGGTAGGTAGTACGG-1	NK cell
CCGTAGGGTTCCCACT-1	NK cell
CCGTAGGTCATACAGC-1	B cell
CCGTGAGAGAGGTCAC-1	CD8 T cell
CCGTGAGTCGCCTTTG-1	B cell
CCGTTCACAGAAGCTG-1	CD8 T cell
CCTAAGAAGACTCTAC-1	CD8 T cell
CCTATCGAGACAGCGT-1	Monocyte
CCTCAACTCTTAGCCC-1	CD4 T cell
CCTCAGTCATGATGCT-1	CD4 T cell
CCTCAGTTCCGAGCTG-1	B cell
CCTCATGCACTATGTG-1	NK cell
CCTCATGGTTTCGCTC-1	CD4 T cell
CCTCATGTCTCTCAAT-1	Monocyte
CCTCCAACAACCCTCT-1	CD8 T cell
CCTCCAACACAATGAA-1	B cell
CCTCCTCAGTCCCGAC-1	B cell
CCTCCTCCATTCAGGT-1	CD4 T cell
CCTCCTCTCAAGCGTT-1	CD4 T cell
CCTCTAGCAGACCTAT-1	Monocyte
CCTCTCCTCGTTCCTG-1	Monocyte
CCTGCATAGTGGTGAC-1	Dendritic cell
CCTGCATCAACGGGTA-1	CD4 T cell
CCTGCATGTTCTTAGG-1	CD4 T cell
CCTGTTGGTGTGCCTG-1	Monocyte
CCTGTTGTCAAGAGTA-1	B cell
CCTTCAGCACAGAGCA-1	B cell
CGAAGGATCGACGCGT-1	CD4 T cell
CGAATTGGTCTGTTAG-1	CD8 T cell
CGAGGAAAGTCGCGAA-1	CD4 T cell
CGAGGAACACTGATTG-1	B cell
CGAGGCTCAGATCACT-1	B cell
CGAGGCTCAGCATGCC-1	Monocyte
CGAGTGCGTTCCGCGA-1	CD4 T cell
CGAGTTAGTCGAGTTT-1	Monocyte
CGATCGGCAATTGGTC-1	Monocyte
CGATCGGCAGCGTGAA-1	CD8 T cell
CGATGCGAGCAGAAAG-1	CD4 T cell
CGATGCGTCGAACCAT-1	B cell
CGATGGCCACTCGATA-1	CD4 T cell
CGATGGCGTAGCGTCC-1	CD4 T cell
CGCAGGTGTGCTTCAA-1	B cell
CGCATAAAGTGATGGC-1	Monocyte
CGCGTGAGTACAATAG-1	B cell
CGGAACCGTATCACGT-1	Monocyte
CGGAACCGTTTGCAGT-1	B cell
CGGACACAGGACAGCT-1	Monocyte
CGGGACTGTTTCACTT-1	NK cell
CGGGTGTTCCGTGACG-1	Monocyte
CGTAAGTGTGATAGTA-1	CD8 T cell
CGTAGTATCAGCCCAG-1	CD8 T cell
CGTCAAACAGAATGTA-1	NK cell
CGTCCATGTTTGGAAA-1	CD4 T cell
CGTGAATAGTCGGCCT-1	CD4 T cell
CGTGCTTAGCTTTGTG-1	Monocyte
CGTGCTTCAAGCGCTC-1	Monocyte
CGTGCTTGTTTAGACC-1	CD4 T cell
CGTGTCTCACAGTACT-1	CD4 T cell
CGTGTCTCATGGGTTT-1	CD4 T cell
CGTGTCTGTCAGTTTG-1	Monocyte
CGTTAGATCAGCCTCT-1	Monocyte
CGTTAGATCCAAGAGG-1	Monocyte
CGTTCTGTCAGCGCAC-1	CD4 T cell
CGTTCTGTCCCGAACG-1	NK cell
CTAACCCAGCCGCTTG-1	CD4 T cell
CTAACCCCACTTCAAG-1	CD4 T cell
CTAAGTGCACAATGCT-1	B cell
CTAAGTGGTCCACTCT-1	CD8 T cell
CTACCTGTCTCGAACA-1	Monocyte
CTACGGGTCGTTCAGA-1	CD8 T cell
CTAGACAGTCTAACTG-1	Monocyte
CTAGGTATCTAACGCA-1	B cell
CTATCCGAGCTGTTAC-1	CD4 T cell
CTCAACCGTGGATGAC-1	B cell
CTCAACCGTGTGTCGC-1	B cell
CTCAAGAAGATTACCC-1	CD8 T cell
CTCAAGAGTCAAAGAT-1	NK cell
CTCAATTTCGGAAGGT-1	Monocyte
CTCACTGCACCTTCCA-1	CD4 T cell
CTCAGGGGTCATCGCG-1	Monocyte
CTCAGGGTCTCACCCA-1	Monocyte
CTCAGTCAGGGACAGG-1	NK cell
CTCATCGAGAGGCGTT-1	CD4 T cell
CTCATCGTCGTACCTC-1	B cell
CTCATTAAGGAAGTGA-1	Monocyte
CTCATTATCGTACACA-1	Dendritic cell
CTCCAACCAATCTCTT-1	CD8 T cell
CTCCAACGTAGTGTGG-1	CD4 T cell
CTCCATGAGACAGCTG-1	B cell
CTCCATGGTGTTGACT-1	Monocyte
CTCCATGTCATCGTAG-1	CD4 T cell
CTCCATGTCGTCGATA-1	Monocyte
CTCCCAATCAATCAGC-1	NK cell
CTCCCTCAGCGCGTTC-1	Monocyte
CTCCCTCGTTTACGAC-1	CD8 T cell
CTCCCTCTCATCGCTC-1	CD8 T cell
CTCCGATTCCTTTAGT-1	CD8 T cell
CTCCGATTCTTTCTAG-1	CD4 T cell
CTCCTCCTCACCTCTG-1	CD4 T cell
CTCCTTTAGATGCTGG-1	Monocyte
CTCCTTTTCTACACTT-1	CD4 T cell
CTCGAGGAGCCTATTG-1	B cell
CTCGAGGAGGAAAGGT-1	CD8 T cell
CTCTCAGGTTAAGCAA-1	CD4 T cell
CTCTCGATCCATAGGT-1	B cell
CTCTGGTAGTAGGATT-1	Monocyte
CTGAATGAGCTCTATG-1	Monocyte
CTGAATGAGGCGAACT-1	CD4 T cell
CTGAGGCGTTCAGCGC-1	B cell
CTGATCCGTCGCGTCA-1	CD4 T cell
CTGATCCTCCCTCTAG-1	CD8 T cell
CTGCAGGAGCCATTGT-1	CD4 T cell
CTGCATCAGCGTCAAG-1	Monocyte
CTGCATCGTAAGCTCT-1	CD8 T cell
CTGCCATTCAGTGTTG-1	CD4 T cell
CTGCCATTCGGAACTT-1	Monocyte
CTGCCTACAAGACTGG-1	Monocyte
CTGCCTATCTTGATTC-1	B cell
CTGCGAGAGATTAGAC-1	Monocyte
CTGCGAGAGTGCACTT-1	Monocyte
CTGCGAGCAGATTCGT-1	B cell
CTGCGAGGTAGGTTTC-1	Monocyte
CTGCTCACAGCGTTTA-1	Monocyte
CTGGACGCAACGATTC-1	CD4 T cell
CTGGACGCACACGGTC-1	Monocyte
CTGGACGGTTCCCAAA-1	CD8 T cell
CTGGACGTCTCATTTG-1	Monocyte
CTGGCAGTCGTCTCAC-1	CD4 T cell
CTGTCGTAGCTGGCCT-1	CD8 T cell
CTGTGAAAGGAACGCT-1	Monocyte
CTGTGAATCATCGCTC-1	Monocyte
CTGTGGGGTCGTGATT-1	B cell
CTTAGGAGTCTGTGGC-1	B cell
CTTCAATGTTGGACTT-1	CD4 T cell
CTTCGGTCACGTTCGG-1	B cell
CTTCGGTTCCAAGAGG-1	B cell
CTTCTCTTCCTACAAG-1	CD8 T cell
CTTGAGAAGAATTGCA-1	CD8 T cell
CTTGATTAGGTAGGCT-1	CD4 T cell
GAACACTGTTGGACTT-1	B cell
GAACGTTGTCAGGAGT-1	Monocyte
GAACTGTCATCGAACT-1	CD4 T cell
GAACTGTTCTCAAAGC-1	CD4 T cell
GAAGAATAGGTACAAT-1	Monocyte
GAAGCCCCAGGAACCA-1	Monocyte
GAAGGACGTCTGCCTT-1	Monocyte
GAAGTAAGTCTAGATC-1	CD4 T cell
GAATCACCAGTGGTGA-1	CD4 T cell
GACACGCCAGTCCGTG-1	B cell
GACACGCGTTCCAAAC-1	B cell
GACAGCCGTATCGTGT-1	CD8 T cell
GACCCTTCAGCGTATT-1	Monocyte
GACCCTTCATCATCTT-1	CD4 T cell
GACCTTCCACCTGCGA-1	Monocyte
GACCTTCGTCGAGCTC-1	CD4 T cell
GACTATGCATCATTGG-1	Monocyte
GACTATGTCCAAGGGA-1	CD4 T cell
GACTCAATCTCCCAAC-1	Monocyte
GACTGATTCATCCTAT-1	CD4 T cell
GACTTCCTCCTCTAGC-1	CD4 T cell
GAGAAATCATTGGATC-1	CD4 T cell
GAGACCCAGTAGGATT-1	Monocyte
GAGACTTAGTCACTCA-1	NK cell
GAGACTTCAGGCTATT-1	Monocyte
GAGAGGTTCATAGACC-1	CD4 T cell
GAGATGGCATGTAACC-1	CD8 T cell
GAGCCTGAGGCAGCTA-1	Dendritic cell
GAGCCTGCAGTCTCTC-1	CD4 T cell
GAGCCTGGTCCACGCA-1	CD4 T cell
GAGCTGCGTCGGATTT-1	Monocyte
GAGGCAAAGTCACGAG-1	CD4 T cell
GAGGGATCACTTGGCG-1	CD4 T cell
GAGGGTACAGTTTCAG-1	CD4 T cell
GAGGGTAGTCAACACT-1	CD8 T cell
GAGGGTATCTGTCCCA-1	CD4 T cell
GAGTGAGGTCGGCTAC-1	B cell
GAGTGTTCACAAGCTT-1	B cell
GAGTGTTGTACGTAGG-1	CD8 T cell
GAGTTACAGACGACGT-1	CD4 T cell
GAGTTGTAGCGTTACT-1	Monocyte
GAGTTGTAGTGCGTCC-1	Monocyte
GAGTTGTCACGGTGCT-1	CD8 T cell
GATAGCTGTCGGAAAC-1	Monocyte
GATAGCTGTCTGTTAG-1	CD4 T cell
GATAGCTTCGTGCAGC-1	B cell
GATCAGTAGGAACATT-1	B cell
GATCAGTAGTGCGCTC-1	CD4 T cell
GATCATGAGGCCTAAG-1	CD4 T cell
GATCCCTAGAGGATGA-1	CD4 T cell
GATCCCTGTAATTAGG-1	CD4 T cell
GATCGTACAGCGCGTT-1	CD4 T cell
GATCGTATCTCTGGTC-1	NK cell
GATGACTTCGTGGCGT-1	CD4 T cell
GATGACTTCTCTAGGA-1	B cell
GATGAGGCAAATGCGG-1	CD4 T cell
GATGATCGTATGGAAT-1	CD8 T cell
GATGATCGTGTAACGG-1	B cell
GATGCTAGTACAGGTG-1	CD8 T cell
GATGGAGAGCCAGACA-1	B cell
GATGGAGCACTTGAAC-1	CD4 T cell
GATGGAGTCTGCGGCA-1	CD4 T cell
GATGGAGTCTTCCAGC-1	Monocyte
GATTCTTGTACAGTCT-1	CD8 T cell
GATTGGTGTTGAGAGC-1	CD4 T cell
GATTTCTCAAGTGGGT-1	CD8 T cell
GATTTCTTCCTTCAGC-1	B cell
GCAACCGTCATTTCCA-1	CD8 T cell
GCAACCGTCGAACGGA-1	B cell
GCACGGTAGTAGTCTC-1	CD4 T cell
GCACGGTCACCCAACG-1	B cell
GCACGTGTCAGACATC-1	NK cell
GCAGCCAAGAGGTCAC-1	B cell
GCAGCCACATACATCG-1	B cell
GCAGCCAGTTGCGTAT-1	B cell
GCAGCCATCACCGGGT-1	CD8 T cell
GCAGCTGGTAAGTTAG-1	Monocyte
GCAGCTGGTGGGTCAA-1	B cell
GCAGCTGTCAAAGCCT-1	Dendritic cell
GCAGCTGTCCTTCTGG-1	CD8 T cell
GCAGTTACACATTCTT-1	Monocyte
GCAGTTATCTCTCTTC-1	Monocyte
GCATCGGGTAACGATA-1	Monocyte
GCCAACGTCTAACGCA-1	NK cell
GCCAACGTCTGCATAG-1	Monocyte
GCCAGGTGTTAGAAAC-1	CD4 T cell
GCCAGTGAGTCCTACA-1	B cell
GCCGATGAGTAACCTC-1	CD4 T cell
GCCGATGCATCTTTCA-1	B cell
GCCGTGACAACGACTT-1	Monocyte
GCCGTGACATGCCGGT-1	CD8 T cell
GCCTGTTCACAGTCAT-1	Monocyte
GCGAGAAAGTTGTAGA-1	Monocyte
GCGAGAATCCTCAGAA-1	CD4 T cell
GCGGAAAGTGTGTCCG-1	CD8 T cell
GCGGATCAGCAACTTC-1	Monocyte
GCTACCTCACGCACCA-1	Monocyte
GCTACCTGTCCTACAA-1	Monocyte
GCTGAATAGCACTCTA-1	B cell
GCTGAATCACACGGAA-1	B cell
GCTGAATTCGTTAGTG-1	Monocyte
GCTGCAGAGGGCAGAG-1	B cell
GCTGCAGGTGCTGATT-1	CD4 T cell
GCTGCAGGTTGACGGA-1	Monocyte
GCTGGGTAGTACAACA-1	NK cell
GCTTGGGAGAAGGTAG-1	Monocyte
GCTTTCGAGTGCAAAT-1	Monocyte
GCTTTCGGTTCGGGTC-1	CD4 T cell
GCTTTCGTCCGGTAGC-1	CD4 T cell
GCTTTCGTCTGGGTCG-1	Monocyte
GGAACCCAGCCATTTG-1	Monocyte
GGAACCCTCTAATTCC-1	B cell
GGAAGTGCAACCCTCT-1	Monocyte
GGAATCTCAAACTGCT-1	CD4 T cell
GGAATCTTCAATCTCT-1	CD4 T cell
GGAATGGAGGACTAAT-1	Monocyte
GGACGTCGTTCAACGT-1	Monocyte
GGAGAACGTGCCCACA-1	Monocyte
GGAGGATGTATGAAAC-1	Monocyte
GGAGGTAAGGCGTTGA-1	Monocyte
GGAGGTATCTGGTGCG-1	Monocyte
GGATCTATCACCTACC-1	CD8 T cell
GGATCTATCATAAGGA-1	CD8 T cell
GGATGTTAGCCGGATA-1	CD4 T cell
GGCGTCACATTGTGCA-1	CD8 T cell
GGCTGTGCAAAGCTAA-1	NK cell
GGCTGTGCACGGTGAA-1	B cell
GGCTGTGGTCCACATA-1	Monocyte
GGCTTGGCACCGAATT-1	B cell
GGCTTGGGTAGATCGG-1	B cell
GGCTTGGTCTTCTTCC-1	Monocyte
GGGACAATCCGATCTC-1	Monocyte
GGGACCTGTTCTTGTT-1	CD8 T cell
GGGACTCCACATATCG-1	CD8 T cell
GGGACTCCACGGGCTT-1	Monocyte
GGGAGATCACGGGTAA-1	CD8 T cell
GGGAGATTCACGGACC-1	B cell
GGGAGTAAGCAGGCAT-1	Monocyte
GGGAGTATCACCTCGT-1	Dendritic cell
GGGAGTATCTTAGCCC-1	Monocyte
GGGATCCAGGGCAATC-1	NK cell
GGGATGAAGGGAGGGT-1	CD4 T cell
GGGATGAAGTCCCGAC-1	CD4 T cell
GGGCCATTCAGACCGC-1	Monocyte
GGGCTACAGACCAAAT-1	CD4 T cell
GGGCTACAGGCAGTCA-1	CD4 T cell
GGGCTCATCGCAATTG-1	CD8 T cell
GGGTAGAAGTAGGGTC-1	CD4 T cell
GGGTCACCAGGAGGTT-1	CD4 T cell
GGGTCACGTCCTTAAG-1	Monocyte
GGGTCACTCACAAGGG-1	Monocyte
GGGTCTGGTTTGAAAG-1	CD4 T cell
GGGTCTGTCCCGTTCA-1	Monocyte
GGGTGAACATAAGCAA-1	CD4 T cell
GGGTTATCAGCCATTA-1	CD4 T cell
GGGTTTACACAGAGCA-1	Monocyte
GGGTTTACACTAAACC-1	B cell
GGTAATCCAAAGGAGA-1	CD8 T cell
GGTAATCCACAGCATT-1	Monocyte
GGTAATCCATACCACA-1	Monocyte
GGTAATCTCAAGTTGC-1	Monocyte
GGTAGAGAGACCAGCA-1	Monocyte
GGTCACGCAATGGCCC-1	CD4 T cell
GGTCACGGTCGTGATT-1	CD4 T cell
GGTCTGGTCAGACATC-1	B cell
GGTCTGGTCTCCCAAC-1	CD8 T cell
GGTGATTAGCTGTACT-1	B cell
GGTGATTCAGCTCGGT-1	Monocyte
GGTGGCTGTGCGCTCA-1	NK cell
GGTGTCGCAACGATCT-1	Monocyte
GGTGTCGGTGTTATCG-1	B cell
GGTGTTAGTGGATTTC-1	B cell
GGTTCTCCAGGTTCCG-1	Monocyte
GTAACACAGCTCCGAC-1	Monocyte
GTAACACGTAGATGTA-1	CD8 T cell
GTAAGTCTCGATTGGT-1	CD4 T cell
GTAATCGCAGTTTCGA-1	CD8 T cell
GTAATCGGTTGCGAAG-1	NK cell
GTAATGCCACCAGTAT-1	Monocyte
GTACAACAGATAGCTA-1	NK cell
GTAGAAACATGGACAG-1	Monocyte
GTAGAAATCTGAGATC-1	Monocyte
GTAGAGGCAACTTCTT-1	CD4 T cell
GTAGATCCATCCCGTT-1	CD4 T cell
GTAGCTATCTCATGGA-1	Monocyte
GTAGGAGTCCGTCACT-1	NK cell
GTAGGTTCAGAAGCGT-1	CD4 T cell
GTAGGTTGTGTTCGTA-1	CD8 T cell
GTAGTACCACCCTATC-1	Monocyte
GTAGTACTCTGTGTGA-1	Dendritic cell
GTATTTCAGAAGAGCA-1	CD8 T cell
GTCAAACCAAGCACCC-1	CD4 T cell
GTCACGGAGCGGGTTA-1	CD4 T cell
GTCACGGCACCGTACG-1	CD4 T cell
GTCACTCTCTTGAACG-1	CD8 T cell
GTCATGAAGTTTGGCT-1	Monocyte
GTCATGACATTGGATC-1	B cell
GTCATTTCAAGAGAGA-1	CD4 T cell
GTCATTTTCCTAGAGT-1	CD8 T cell
GTCCCATCATGCCGAC-1	CD4 T cell
GTCCTCAAGTCACGAG-1	B cell
GTCGAATAGGAGTATT-1	B cell
GTCGAATCAGAACCGA-1	Monocyte
GTCGAATGTCAAGCGA-1	Monocyte
GTCGCGAAGCAGCGAT-1	CD8 T cell
GTCGCGAGTTTACCTT-1	NK cell
GTCTACCCAGGAAGTC-1	CD4 T cell
GTCTAGAGTATGTCAC-1	Dendritic cell
GTCTAGATCGAGAGAC-1	B cell
GTCTGTCAGATACGAT-1	CD4 T cell
GTCTGTCTCGAGCCTG-1	NK cell
GTGAGCCGTGATCGTT-1	NK cell
GTGAGCCTCTGGAAGG-1	Monocyte
GTGAGGAAGCATTGAA-1	CD4 T cell
GTGAGGACACAACATC-1	CD8 T cell
GTGAGGACACTTTAGG-1	CD4 T cell
GTGAGTTTCCAATGCA-1	CD4 T cell
GTGATGTAGACATCAA-1	CD4 T cell
GTGCGTGAGCTTCTAG-1	Monocyte
GTGCTGGCAGGCTACC-1	NK cell
GTGCTGGTCAAACCTG-1	CD4 T cell
GTGCTTCAGACCATAA-1	Monocyte
GTGCTTCCACTCATAG-1	NK cell
GTGCTTCGTCGCTTGG-1	Monocyte
GTGGAAGAGCCAAGTG-1	B cell
GTGGCGTAGAATAACC-1	CD8 T cell
GTGGCGTCAATCGAAA-1	CD4 T cell
GTGGGAAAGGTCGTAG-1	B cell
GTGGGAACATGAGTAA-1	CD4 T cell
GTGGTTAAGTAACCGG-1	CD4 T cell
GTGTAACTCTTGGTGA-1	CD8 T cell
GTGTCCTAGTCGGCCT-1	NK cell
GTGTCCTCAGTTGTTG-1	B cell
GTGTCCTGTGGCCTCA-1	CD4 T cell
GTGTGATCACTACGGC-1	CD4 T cell
GTGTGATTCTTACGTT-1	NK cell
GTGTGGCAGGTACTGG-1	Dendritic cell
GTGTGGCAGGTAGTCG-1	CD8 T cell
GTGTGGCTCACCACAA-1	CD8 T cell
GTTACAGAGTGTAGTA-1	CD4 T cell
GTTACAGCAAATCAGA-1	CD4 T cell
GTTACGAGTATGAGAT-1	Monocyte
GTTAGTGAGAACGTGC-1	CD4 T cell
GTTAGTGCACCTCTAC-1	Monocyte
GTTCCGTAGTTGCCCG-1	Monocyte
GTTCCGTCACCCGTAG-1	CD8 T cell
GTTCTATCAAATGAGT-1	B cell
GTTCTATCACGTGTGC-1	Monocyte
GTTCTATTCTACACTT-1	NK cell
GTTGAACAGGAACATT-1	NK cell
GTTGAACGTACCCGCA-1	Monocyte
GTTGCGGAGCTGCCTG-1	CD4 T cell
GTTGCTCAGTTTCGAC-1	NK cell
GTTGCTCTCATTTCCA-1	CD4 T cell
GTTGTAGCAGTTCTAG-1	CD8 T cell
GTTGTGATCTCGGTCT-1	CD4 T cell
GTTTGGAGTGTATACC-1	CD4 T cell
TAACGACCACATATGC-1	CD4 T cell
TAACTTCGTTGTGGAG-1	NK cell
TAAGCACAGAAGCTGC-1	CD4 T cell
TAAGCACTCACCATAG-1	B cell
TAAGCCATCTGGCCTT-1	B cell
TAAGCGTTCGTTGCCT-1	B cell
TAAGCGTTCTGTCGTC-1	CD4 T cell
TAATTCCCACTCCGGA-1	CD8 T cell
TAATTCCGTATTGACC-1	Monocyte
TAATTCCGTCAGTCCG-1	CD4 T cell
TACAACGCAAAGGTTA-1	CD4 T cell
TACAACGCATAGATCC-1	CD4 T cell
TACACCCTCGACTCCT-1	CD8 T cell
TACAGGTTCCTTACCG-1	CD8 T cell
TACATTCGTGGCTTAT-1	CD4 T cell
TACCTCGCACCCAACG-1	CD8 T cell
TACCTGCAGTCTGCAT-1	CD4 T cell
TACCTGCTCCAAGCTA-1	B cell
TACGCTCTCTCGGTCT-1	Monocyte
TACGCTCTCTTAAGGC-1	B cell
TACGGGCTCAACGAGG-1	CD8 T cell
TACGGGCTCTACCACC-1	CD4 T cell
TACGTCCCAAGTGATA-1	Monocyte
TACTTCATCATGCCGG-1	CD8 T cell
TAGACTGAGATTGTGA-1	B cell
TAGACTGGTCTTGAAC-1	Monocyte
TAGACTGTCGCCGAGT-1	Monocyte
TAGAGTCGTTGTGTAC-1	Monocyte
TAGATCGCAAATGGTA-1	Monocyte
TAGATCGCACACGCCA-1	CD4 T cell
TAGATCGTCACAACCA-1	Monocyte
TAGCACAAGTACTCGT-1	Monocyte
TAGGAGGCAAGACCTT-1	B cell
TAGGAGGGTTCCAGGC-1	B cell
TAGGGTTAGAGAGCGG-1	CD4 T cell
TAGGGTTAGGAACATT-1	B cell
TAGGTACGTGTCATCA-1	Monocyte
TAGGTACTCGAAGCAG-1	NK cell
TAGTGCACACTCGATA-1	Monocyte
TAGTGCACAGAGGAAA-1	Monocyte
TATACCTGTTCTCGTC-1	CD8 T cell
TATACCTTCTGTCCGT-1	Monocyte
TATATCCCATGCGTGC-1	B cell
TATGTTCAGTATGGAT-1	CD8 T cell
TATTGCTTCTCGAACA-1	NK cell
TCAAGCATCCACTTTA-1	CD4 T cell
TCAATCTAGAGGTTTA-1	CD4 T cell
TCAATCTGTTTCCCAC-1	B cell
TCACAAGGTAGTGGCA-1	CD8 T cell
TCACAAGGTGGATACG-1	Monocyte
TCACACCCACCAGCCA-1	Monocyte
TCACACCGTCTCACGG-1	CD8 T cell
TCACACCGTTAAACCC-1	Monocyte
TCACACCTCTGGGAGA-1	CD4 T cell
TCACACCTCTTACCAT-1	CD8 T cell
TCACATTCAGAACTAA-1	Monocyte
TCACATTCATGCCATA-1	CD4 T cell
TCACGCTAGGACATCG-1	CD8 T cell
TCACGCTGTCTGCCTT-1	CD4 T cell
TCACGCTTCACTAGCA-1	CD8 T cell
TCACGCTTCGGACTGC-1	CD4 T cell
TCACGGGCAACCGACC-1	Monocyte
TCACTATGTTTAGACC-1	CD8 T cell
TCACTCGCAAAGCAAT-1	Monocyte
TCACTCGGTCAACCAT-1	CD4 T cell
TCACTCGTCGGTCATA-1	Monocyte
TCAGCAACAAATCAAG-1	Monocyte
TCAGCAAGTATGACAA-1	Dendritic cell
TCAGGGCTCATGCGGC-1	CD4 T cell
TCAGGTACAATCGCAT-1	B cell
TCAGGTAGTATGGTAA-1	CD4 T cell
TCAGTCCGTAAGATCA-1	Monocyte
TCAGTCCGTCTCTCAC-1	CD4 T cell
TCAGTTTAGGATATAC-1	Monocyte
TCATACTCAGGTACGA-1	CD8 T cell
TCATACTTCAGAGCAG-1	CD4 T cell
TCATATCCATGCTGCG-1	Dendritic cell
TCATCATAGCACACAG-1	Monocyte
TCATCATGTTGCACGC-1	Monocyte
TCATCCGTCCAACTGA-1	B cell
TCATGCCCAAAGCGTG-1	CD8 T cell
TCATGCCGTGTCTTAG-1	CD8 T cell
TCATGTTAGAGGCGGA-1	B cell
TCATGTTGTGTGTGTT-1	CD4 T cell
TCATTACGTGCATGAG-1	CD8 T cell
TCATTGTGTGAGCAGT-1	CD4 T cell
TCCATCGGTTTAGTCG-1	B cell
TCCCACACAGACCAAG-1	Monocyte
TCCCAGTAGACCGTTT-1	Monocyte
TCCCAGTTCGACATAC-1	Monocyte
TCCCATGTCGGCCCAA-1	CD4 T cell
TCCGATCTCAAACCTG-1	CD4 T cell
TCCTCCCAGTCTAACC-1	Monocyte
TCCTCGATCTCTCGAC-1	CD4 T cell
TCCTCTTAGAGTGAAG-1	Monocyte
TCCTTTCTCGCTGTCT-1	Dendritic cell
TCGAAGTGTATCAGGG-1	CD8 T cell
TCGACCTCAAAGACTA-1	CD4 T cell
TCGACCTCAAGTAGTA-1	B cell
TCGACGGTCGAAGTGG-1	CD4 T cell
TCGATTTGTACGCTTA-1	CD8 T cell
TCGCAGGAGATTGACA-1	CD8 T cell
TCGCAGGGTAGGCTCC-1	CD4 T cell
TCGCAGGGTTCTAACG-1	CD4 T cell
TCGCTCACAAGATTGA-1	CD4 T cell
TCGCTTGAGAGACAAG-1	CD8 T cell
TCGCTTGAGCATTTGC-1	CD8 T cell
TCGGGACTCTAGATCG-1	CD4 T cell
TCGGGCATCCGATTAG-1	CD4 T cell
TCGGGCATCTGAACGT-1	Monocyte
TCGGGTGCAGTCTGGC-1	Monocyte
TCGGTCTTCATTGCTT-1	CD4 T cell
TCGGTCTTCGACATAC-1	CD4 T cell
TCGTAGACAATGAAAC-1	Monocyte
TCGTGCTGTAAGGAGA-1	CD4 T cell
TCGTGCTGTGATCATC-1	Dendritic cell
TCTACCGCAGTCGTTA-1	CD4 T cell
TCTACCGTCCACGGAC-1	CD8 T cell
TCTATACGTTATCCAG-1	Monocyte
TCTATCAGTATGCTAC-1	Monocyte
TCTCACGAGGCTCCCA-1	CD8 T cell
TCTCCGATCTCTCTTC-1	B cell
TCTCTGGCAAAGCAAT-1	Monocyte
TCTGCCAGTAACGCGA-1	CD4 T cell
TCTGCCAGTAGATGTA-1	Monocyte
TCTGGCTCATCCTGTC-1	CD8 T cell
TCTGTCGAGACTAGAT-1	Monocyte
TCTGTCGCACCAGCGT-1	NK cell
TCTTAGTAGGCCTGCT-1	CD4 T cell
TCTTAGTCAACACGAG-1	Monocyte
TCTTAGTGTTGCCAAT-1	Monocyte
TCTTAGTTCAGAATAG-1	CD8 T cell
TCTTGCGAGATGAAGG-1	CD4 T cell
TCTTGCGCACTACTTT-1	B cell
TCTTGCGCAGAGGAAA-1	CD4 T cell
TCTTGCGGTCCAGCCA-1	CD4 T cell
TCTTTGAGTGGAGAAA-1	B cell
TGAACGTCAAATGAAC-1	CD8 T cell
TGAACGTGTAACTAAG-1	CD4 T cell
TGAATGCGTGGACTAG-1	B cell
TGAATGCTCGACGAGA-1	Monocyte
TGAATGCTCGCCGTGA-1	Monocyte
TGACAGTTCGAGATGG-1	B cell
TGACCCTTCTCATTGT-1	Monocyte
TGACGCGGTGGCTTAT-1	Monocyte
TGACTCCAGTCTCCTC-1	CD4 T cell
TGACTCCCACCATAAC-1	Monocyte
TGAGACTAGGCTGAAC-1	CD4 T cell
TGAGCATTCCATTGCC-1	CD8 T cell
TGAGCATTCCTTCACG-1	CD4 T cell
TGAGCATTCGATACTG-1	CD4 T cell
TGAGCATTCTGTCTCG-1	Monocyte
TGAGCGCCACTATGTG-1	Monocyte
TGAGCGCCAGCATACT-1	Monocyte
TGAGCGCTCGTCTAAG-1	CD8 T cell
TGAGGAGTCCATCGTC-1	B cell
TGAGGGATCAAACGTC-1	B cell
TGAGGTTCAAACTAGA-1	Monocyte
TGAGGTTCAGGACATG-1	Monocyte
TGAGGTTGTAGCTTTG-1	Monocyte
TGAGTCACAGAACGCA-1	Monocyte
TGAGTCAGTAACCCTA-1	CD8 T cell
TGAGTCAGTCACTCTC-1	Monocyte
TGATCAGAGGATTCAA-1	Monocyte
TGATGCACAGGGCTTC-1	CD8 T cell
TGATGGTAGACCCGCT-1	NK cell
TGCACGGTCGAGTACT-1	B cell
TGCAGGCAGCGTTCAT-1	CD4 T cell
TGCAGGCCAGGAATAT-1	CD4 T cell
TGCAGTAAGTAGTCCT-1	B cell
TGCAGTATCCACATAG-1	Monocyte
TGCATCCCACCCAACG-1	B cell
TGCATGAAGCACCCAC-1	CD4 T cell
TGCGACGAGCGACAGT-1	NK cell
TGCGATAAGAATCGCG-1	CD8 T cell
TGCGGCAAGTGGTGAC-1	CD8 T cell
TGCGGCACAAAGACGC-1	CD4 T cell
TGCTCCACAATCTAGC-1	CD8 T cell
TGCTCGTAGACGAGCT-1	CD8 T cell
TGCTCGTTCCCATTTA-1	B cell
TGCTGAACAGCACAAG-1	CD4 T cell
TGCTTCGCATAGCTGT-1	Monocyte
TGCTTGCGTGAACTAA-1	CD4 T cell
TGGAACTAGCGTCTCG-1	Monocyte
TGGAGAGCAGTCAGTT-1	Monocyte
TGGAGGAAGTAGGAAG-1	Monocyte
TGGATCAGTTCTCCCA-1	Monocyte
TGGATGTTCACGGGAA-1	CD8 T cell
TGGGAAGTCGATTGGT-1	CD8 T cell
TGGGAGAAGCAAGTGC-1	B cell
TGGGAGAAGTGGTGGT-1	Monocyte
TGGGATTAGTCACGAG-1	NK cell
TGGGATTGTACGATGG-1	Monocyte
TGGGCGTAGTGGAATT-1	B cell
TGGGCTGAGAGGGTCT-1	CD4 T cell
TGGGCTGAGCGTTAGG-1	Monocyte
TGGGCTGCATCCGATA-1	B cell
TGGGCTGGTCGCGGTT-1	NK cell
TGGGTTAGTATTGAGA-1	Monocyte
TGGGTTAGTGCACGCT-1	B cell
TGGGTTATCAGTAGGG-1	Monocyte
TGGTACACAAAGGGTC-1	CD8 T cell
TGGTAGTCAGGCATGA-1	CD8 T cell
TGGTAGTCATCACAGT-1	CD4 T cell
TGGTAGTTCCCTCATG-1	Monocyte
TGTACAGAGACTCGAG-1	Monocyte
TGTACAGAGTGAGTTA-1	Monocyte
TGTACAGGTGGATTTC-1	CD4 T cell
TGTAGACTCCATTTAC-1	Monocyte
TGTCAGACAACTTGGT-1	CD4 T cell
TGTCAGACACTCACTC-1	CD4 T cell
TGTCCACCAACTGGTT-1	CD8 T cell
TGTCCACTCGCTTACC-1	B cell
TGTCCCAAGCTCCATA-1	CD4 T cell
TGTCCCAAGGTCATAA-1	B cell
TGTCCCACATACTTTC-1	CD8 T cell
TGTCCCAGTCAGGCAA-1	Monocyte
TGTCCCAGTCGGTGTC-1	Monocyte
TGTCCTGGTACTTGTG-1	CD4 T cell
TGTCCTGGTTGGCTAT-1	B cell
TGTGATGAGCGACTGA-1	B cell
TGTGATGCATTCTCTA-1	CD4 T cell
TGTGCGGGTCGTCGGT-1	NK cell
TGTGCGGTCACATACG-1	Monocyte
TGTGGCGTCGTACCTC-1	Monocyte
TGTGTGATCTGACAGT-1	CD4 T cell
TGTTCATGTCCTGGGT-1	CD8 T cell
TGTTCCGCAAGTATAG-1	B cell
TGTTGAGCACAACGAG-1	Monocyte
TGTTGAGTCTCGACCT-1	B cell
TTAATCCAGCTACTAC-1	Monocyte
TTACAGGGTGATTCTG-1	CD8 T cell
TTACCGCGTCCGAAAG-1	Monocyte
TTACGCCCACGTCGTG-1	Monocyte
TTACGCCTCAATGCAC-1	CD4 T cell
TTACGTTGTTTACGAC-1	CD4 T cell
TTACGTTTCTCGCTTG-1	CD4 T cell
TTACTGTCATACATCG-1	B cell
TTACTGTGTAAGAACT-1	Monocyte
TTACTGTGTTAAGGGC-1	B cell
TTAGGGTGTCACATTG-1	CD8 T cell
TTAGTCTCACGTATAC-1	CD4 T cell
TTATTGCCAAACGGCA-1	B cell
TTATTGCGTACGTAGG-1	Monocyte
TTATTGCGTCAACACT-1	NK cell
TTATTGCGTGTCTTCC-1	Monocyte
TTCACCGCAGCCCAGT-1	B cell
TTCACGCGTTAAGTCC-1	CD4 T cell
TTCACGCTCTATCCAT-1	CD4 T cell
TTCAGGAAGATTGGGC-1	CD4 T cell
TTCAGGAGTCTACAAC-1	B cell
TTCATGTAGGTCATAA-1	CD4 T cell
TTCCACGGTCAACACT-1	B cell
TTCCGTGCACTCACTC-1	CD4 T cell
TTCCGTGGTTCCAGGC-1	B cell
TTCCTCTGTACCTGTA-1	Monocyte
TTCCTTCAGGTAGTCG-1	Monocyte
TTCCTTCAGTAGTCAA-1	CD4 T cell
TTCCTTCGTGACACGA-1	Monocyte
TTCGCTGAGGGTTAGC-1	CD8 T cell
TTCGCTGCACTAGTAC-1	B cell
TTCGCTGTCGGACTGC-1	CD4 T cell
TTCTCTCGTATCGTAC-1	CD4 T cell
TTCTTGAGTCTTGCTC-1	Monocyte
TTGACCCGTCTCGGGT-1	CD8 T cell
TTGACCCTCGTAGTGT-1	CD4 T cell
TTGATGGCATAAGATG-1	B cell
TTGCATTGTGCCTTCT-1	Dendritic cell
TTGCCTGAGAGTGACC-1	Monocyte
TTGCCTGAGTGGAAAG-1	Monocyte
TTGCCTGGTAGCTGCC-1	Monocyte
TTGCTGCCATTGCCGG-1	Monocyte
TTGGGATCAACGGGTA-1	CD8 T cell
TTGGGATTCAGGAAGC-1	Monocyte
TTGGGATTCTCTCTAA-1	Monocyte
TTGGGCGCACGGTGAA-1	CD4 T cell
TTGGGCGGTCGGAAAC-1	B cell
TTGGGTAGTGCTAGCC-1	Monocyte
TTGGGTATCACCGACG-1	Monocyte
TTGGTTTCACTGGATT-1	CD8 T cell
TTGTGGATCTAAGAAG-1	CD4 T cell
TTGTGTTGTGTGTCCG-1	CD4 T cell
TTGTTCACAGTCGCTG-1	Monocyte
TTGTTCATCTTTACAC-1	Monocyte
TTGTTTGAGGTCGACA-1	CD4 T cell
TTTACTGTCACGGGAA-1	B cell
TTTATGCGTAACATAG-1	CD8 T cell
TTTATGCGTTGATCGT-1	B cell
TTTCACATCTCAGGCG-1	B cell
TTTCATGGTGCCTAAT-1	B cell
TTTCATGTCACTCACC-1	Monocyte
TTTCCTCCACAGAGCA-1	B cell
TTTCCTCTCCTACACC-1	CD4 T cell
TTTCCTCTCTCTTGCG-1	Monocyte
TTTGATCTCTTTGGAG-1	CD4 T cell
TTTGGTTAGTAACCTC-1	CD4 T cell
TTTGGTTGTAGAATAC-1	Monocyte
TTTGTTGCAATTAGGA-1	B cell
