cell	celltype
AAACCTGAGCGCTCCA-1	Monocyte
AAACCTGGTGATAAAC-1	Monocyte
AAACGGGGTTTGTGTG-1	CD4 T cell
AAAGATGAGTACTTGC-1	Monocyte
AAAGCAAGTCTCTTAT-1	NK cell
AAAGCAATCCACGAAT-1	CD4 T cell
AAAGTAGGTAGCAAAT-1	CD8 T cell
AAATGCCGTCTAGAGG-1	Other
AACACGTCACCTCGGA-1	CD4 T cell
AACACGTCATGGTTGT-1	B cell
AACACGTTCTGTCAAG-1	Monocyte
AACCATGCACCACGTG-1	CD4 T cell
AACCATGCAGGTCTCG-1	Monocyte
AACCATGGTAGTACCT-1	Monocyte
AACCATGGTGGGTATG-1	CD4 T cell
AACCGCGCACATCTTT-1	CD4 T cell
AACCGCGCATGCCTAA-1	B cell
AACGTTGAGAAAGTGG-1	Monocyte
AACGTTGAGCCGCCTA-1	CD8 T cell
AACGTTGTCACAGTAC-1	CD8 T cell
AACGTTGTCTGCGTAA-1	CD4 T cell
AACTCAGTCACTGGGC-1	Monocyte
AACTCTTCATCCAACA-1	Monocyte
AACTCTTGTGTCCTCT-1	Monocyte
AACTGGTCAGGACCCT-1	Monocyte
AACTTTCCAGAAGCAC-1	Monocyte
AACTTTCTCTGGCGTG-1	Monocyte
AACTTTCTCTGTTTGT-1	CD4 T cell
AAGACCTGTTAGTGGG-1	Monocyte
AAGACCTTCAAACGGG-1	CD4 T cell
AAGACCTTCAGCCTAA-1	NK cell
AAGGAGCAGTATCGAA-1	CD4 T cell
AAGGAGCAGTGGTAGC-1	Dendritic cell
AAGGAGCCAGCTTAAC-1	Monocyte
AAGGAGCTCAGATAAG-1	CD8 T cell
AAGGAGCTCTAAGCCA-1	Monocyte
AATCCAGTCCCAACGG-1	Monocyte
ACACCAATCACTATTC-1	CD4 T cell
ACACCCTGTTCAGTAC-1	Monocyte
ACACCGGTCTAACGGT-1	B cell
ACACTGAAGTTAAGTG-1	CD4 T cell
ACACTGATCAATACCG-1	Monocyte
ACACTGATCACGCATA-1	CD4 T cell
ACATACGCACACCGCA-1	CD4 T cell
ACATACGTCTGCCCTA-1	CD8 T cell
ACATACGTCTGGCGAC-1	CD4 T cell
ACATCAGCAAACGCGA-1	CD8 T cell
ACATGGTAGAGGTACC-1	CD4 T cell
ACATGGTCAACTGGCC-1	Monocyte
ACATGGTCAGACTCGC-1	B cell
ACATGGTCATTCTTAC-1	Monocyte
ACATGGTGTGGTACAG-1	B cell
ACCAGTAAGCCTCGTG-1	CD4 T cell
ACCAGTATCCCTGACT-1	Monocyte
ACCCACTCAAAGGCGT-1	B cell
ACCGTAACACAACGCC-1	Monocyte
ACCGTAAGTTCAGTAC-1	Monocyte
ACCGTAATCTTGGGTA-1	CD4 T cell
ACCTTTAAGGATATAC-1	Monocyte
ACCTTTACACCAGCAC-1	Monocyte
ACCTTTACACTATCTT-1	CD4 T cell
ACGAGCCAGAGTAAGG-1	CD4 T cell
ACGAGCCCAAGAGTCG-1	NK cell
ACGAGCCCAGTCGATT-1	Monocyte
ACGAGCCGTGCTGTAT-1	CD8 T cell
ACGAGCCTCTTGTATC-1	Monocyte
ACGAGGACACGGCCAT-1	CD4 T cell
ACGAGGATCCTATGTT-1	Monocyte
ACGAGGATCTTTAGTC-1	B cell
ACGATACAGCAGGCTA-1	Monocyte
ACGATACAGCGCTTAT-1	B cell
ACGATACCAAAGTCAA-1	CD4 T cell
ACGATACGTCGCGTGT-1	Monocyte
ACGCAGCAGTTAAGTG-1	B cell
ACGCAGCTCACCGTAA-1	B cell
ACGCAGCTCCCAAGTA-1	B cell
ACGCCGAAGCGCTTAT-1	B cell
ACGGAGACACATCCGG-1	CD8 T cell
ACGGAGACATCTATGG-1	CD8 T cell
ACGGCCACACCGAAAG-1	CD8 T cell
ACGGCCAGTTATCACG-1	B cell
ACGGGCTCAAGTACCT-1	B cell
ACGGGCTGTCGGCACT-1	Dendritic cell
ACGGGTCAGGCATGTG-1	Monocyte
ACGGGTCCAACACGCC-1	Monocyte
ACGGGTCCACACCGCA-1	CD4 T cell
ACTATCTTCTGACCTC-1	NK cell
ACTGAACAGCGTGAGT-1	B cell
ACTGAACAGGACAGCT-1	Monocyte
ACTGAACCAAGCCGCT-1	CD8 T cell
ACTGAACTCAAACCAC-1	CD4 T cell
ACTGAGTAGACGACGT-1	B cell
ACTGAGTTCAATCTCT-1	CD4 T cell
ACTGAGTTCCCACTTG-1	CD4 T cell
ACTGAGTTCGGAGCAA-1	Monocyte
ACTGAGTTCGTCTGAA-1	CD8 T cell
ACTGATGCAAGTTCTG-1	Monocyte
ACTGATGTCTTAGCCC-1	Dendritic cell
ACTGCTCAGTTAGGTA-1	CD4 T cell
ACTGCTCGTACTTCTT-1	CD4 T cell
ACTGCTCGTAGAAAGG-1	Other
ACTGCTCGTAGGCTGA-1	Monocyte
ACTGCTCGTGCAGGTA-1	B cell
ACTGCTCGTGTGTGCC-1	CD8 T cell
ACTGTCCAGAGCTGCA-1	CD4 T cell
ACTGTCCAGATGTAAC-1	CD8 T cell
ACTGTCCAGTCCCACG-1	B cell
ACTGTCCCATCGATGT-1	CD8 T cell
ACTGTCCTCCCACTTG-1	CD8 T cell
ACTTACTAGTTAGCGG-1	B cell
ACTTACTGTCCCTTGT-1	Monocyte
ACTTACTGTTACCAGT-1	CD8 T cell
ACTTGTTAGTGAACGC-1	Monocyte
ACTTGTTCATTGCGGC-1	Monocyte
ACTTGTTGTTCAGTAC-1	B cell
ACTTGTTTCCAAGCCG-1	Monocyte
ACTTGTTTCCCATTAT-1	NK cell
ACTTTCAAGCCATCGC-1	Monocyte
ACTTTCAGTCTCCACT-1	Monocyte
ACTTTCAGTTAAAGTG-1	Monocyte
AGAATAGCAGCTGTAT-1	Dendritic cell
AGAATAGTCGTCACGG-1	Monocyte
AGACGTTCAACGCACC-1	CD8 T cell
AGACGTTCAAGGCTCC-1	Dendritic cell
AGACGTTCAGACTCGC-1	Monocyte
AGACGTTGTCAAAGCG-1	CD4 T cell
AGACGTTTCAGTTTGG-1	CD4 T cell
AGAGCTTAGATGCCAG-1	CD4 T cell
AGAGCTTGTGACGCCT-1	CD4 T cell
AGAGTGGCAGATGAGC-1	CD4 T cell
AGAGTGGTCGGCGCAT-1	B cell
AGAGTGGTCTCTGAGA-1	NK cell
AGAGTGGTCTTTAGGG-1	B cell
AGATCTGCATAGGATA-1	Monocyte
AGATCTGGTTCACGGC-1	CD8 T cell
AGATCTGTCATGTAGC-1	Other
AGATTGCGTCGTCTTC-1	B cell
AGATTGCGTCTCATCC-1	CD8 T cell
AGCAGCCGTCTCCATC-1	Monocyte
AGCATACCAGGGTATG-1	Monocyte
AGCCTAAAGTTAGGTA-1	Monocyte
AGCCTAACAGCCTGTG-1	Monocyte
AGCCTAAGTTTAGGAA-1	B cell
AGCCTAATCCCGACTT-1	B cell
AGCCTAATCTCAAACG-1	B cell
AGCGGTCAGTACATGA-1	CD4 T cell
AGCGGTCGTTATGCGT-1	Monocyte
AGCGGTCGTTCCACGG-1	Monocyte
AGCGTCGGTGACTCAT-1	CD8 T cell
AGCGTCGTCCCTTGCA-1	CD8 T cell
AGCGTCGTCGGGAGTA-1	CD4 T cell
AGCTCCTGTGTATGGG-1	NK cell
AGCTCCTGTGTTTGGT-1	CD4 T cell
AGCTCCTGTTCGTCTC-1	CD4 T cell
AGCTCTCAGTGTTAGA-1	CD4 T cell
AGGCCACCAGCAGTTT-1	CD8 T cell
AGGCCACGTCAGCTAT-1	CD4 T cell
AGGCCACGTGCAGGTA-1	CD4 T cell
AGGCCACTCGTGGTCG-1	Monocyte
AGGCCGTCAGCCTTGG-1	CD4 T cell
AGGCCGTCATATGCTG-1	Monocyte
AGGGAGTAGGGTCTCC-1	CD8 T cell
AGGGAGTTCCTTAATC-1	CD8 T cell
AGGGAGTTCGATGAGG-1	CD4 T cell
AGGGATGGTTCAGGCC-1	Monocyte
AGGGATGTCTCTGAGA-1	NK cell
AGGGATGTCTTGACGA-1	Monocyte
AGGTCATAGCTCCTCT-1	B cell
AGGTCATCACAGTCGC-1	CD4 T cell
AGGTCATCATCCGTGG-1	Monocyte
AGGTCATGTCTAGAGG-1	CD4 T cell
AGGTCCGCATGCAACT-1	CD8 T cell
AGTAGTCAGCGATTCT-1	Monocyte
AGTAGTCAGGATGTAT-1	B cell
AGTAGTCGTCATATGC-1	Monocyte
AGTCTTTAGAATCTCC-1	CD4 T cell
AGTCTTTAGCAGGCTA-1	CD8 T cell
AGTGAGGCAATCGGTT-1	Monocyte
AGTGAGGTCGAACGGA-1	CD4 T cell
AGTGGGAAGCGTGAAC-1	Monocyte
AGTGGGACAGTAACGG-1	Monocyte
AGTGGGATCCATGAGT-1	NK cell
AGTGTCAAGGCGATAC-1	CD4 T cell
AGTGTCAGTTCCATGA-1	CD8 T cell
ATAACGCGTAAGCACG-1	Monocyte
ATAACGCGTCGGCACT-1	NK cell
ATAACGCGTCTGATTG-1	B cell
ATAAGAGCACCAGGTC-1	B cell
ATAAGAGCACTTCTGC-1	NK cell
ATAAGAGTCGGGAGTA-1	CD4 T cell
ATAGACCGTCCTAGCG-1	CD4 T cell
ATAGACCGTTGTGGAG-1	Monocyte
ATAGACCTCATCACCC-1	CD4 T cell
ATAGACCTCCTGCAGG-1	CD4 T cell
ATCACGACATATGCTG-1	NK cell
ATCACGAGTCCGACGT-1	Monocyte
ATCACGAGTCTCATCC-1	B cell
ATCATCTCAGTGGAGT-1	CD4 T cell
ATCATGGGTCCAAGTT-1	B cell
ATCATGGTCACGACTA-1	CD4 T cell
ATCATGGTCCGTACAA-1	CD4 T cell
ATCCACCCATTACGAC-1	CD4 T cell
ATCCACCGTTTGACAC-1	Monocyte
ATCCGAACAGGTGGAT-1	CD4 T cell
ATCGAGTAGGAGCGAG-1	Monocyte
ATCGAGTAGTACACCT-1	Monocyte
ATCGAGTCAACACCCG-1	CD4 T cell
ATCGAGTCAGGTCTCG-1	CD8 T cell
ATCGAGTGTACCGTAT-1	CD4 T cell
ATCGAGTGTTCCGTCT-1	CD4 T cell
ATCTACTCACTTAACG-1	B cell
ATCTGCCAGGTGTGGT-1	CD4 T cell
ATCTGCCCACCAGGCT-1	CD4 T cell
ATCTGCCCAGTAGAGC-1	CD4 T cell
ATCTGCCGTTCCTCCA-1	CD4 T cell
ATCTGCCTCGCCATAA-1	CD8 T cell
ATGAGGGCAGCTGCTG-1	Monocyte
ATGAGGGGTCTTCAAG-1	CD4 T cell
ATGAGGGTCACTCTTA-1	B cell
ATGCGATTCCAGATCA-1	Monocyte
ATGCGATTCCGGGTGT-1	Monocyte
ATGTGTGAGGCTAGAC-1	Monocyte
ATGTGTGAGGCTCAGA-1	Monocyte
ATTACTCAGACCCACC-1	CD8 T cell
ATTACTCAGAGTTGGC-1	CD4 T cell
ATTATCCAGGCAATTA-1	CD4 T cell
ATTCTACAGTTTCCTT-1	Other
ATTCTACTCACGCATA-1	Monocyte
ATTCTACTCATTGCGA-1	CD4 T cell
ATTGGACAGGAACTGC-1	B cell
ATTGGACAGTCGCCGT-1	Monocyte
ATTGGACCATCAGTAC-1	NK cell
ATTGGACGTGAAGGCT-1	Monocyte
ATTGGACGTTCCCGAG-1	CD8 T cell
ATTGGTGAGATAGTCA-1	CD4 T cell
ATTGGTGCAATGGACG-1	B cell
ATTTCTGTCCAATGGT-1	CD4 T cell
ATTTCTGTCTAACTCT-1	Monocyte
CAACCAAGTCCGTCAG-1	B cell
CAACCTCCAATGGTCT-1	Monocyte
CAACTAGTCATGGTCA-1	B cell
CAAGAAACAGGATCGA-1	Monocyte
CAAGAAAGTTCCGTCT-1	CD4 T cell
CAAGAAATCATCGCTC-1	CD4 T cell
CAAGAAATCTGTTTGT-1	Monocyte
CAAGATCTCGTAGGTT-1	CD8 T cell
CAAGGCCCAATCTACG-1	CD4 T cell
CAAGGCCGTGGCTCCA-1	Monocyte
CAAGGCCGTTATTCTC-1	CD4 T cell
CAAGGCCTCAAGGCTT-1	B cell
CAAGTTGAGAACTCGG-1	B cell
CAAGTTGGTGTGACCC-1	NK cell
CAAGTTGTCAGTTGAC-1	Monocyte
CAAGTTGTCGTACGGC-1	CD4 T cell
CACAAACAGCCCAATT-1	CD8 T cell
CACAAACAGCCGGTAA-1	CD8 T cell
CACACAAGTCGAACAG-1	CD4 T cell
CACACCTAGTATCGAA-1	NK cell
CACACCTTCCCAACGG-1	CD4 T cell
CACACTCCAGGTGGAT-1	Monocyte
CACACTCCATATGAGA-1	CD4 T cell
CACACTCCATTAGCCA-1	Monocyte
CACAGGCCAGTCCTTC-1	CD4 T cell
CACAGGCGTCATGCCG-1	CD8 T cell
CACAGTAAGCTGTCTA-1	CD4 T cell
CACAGTACAGTCGTGC-1	CD4 T cell
CACAGTAGTCCGAATT-1	CD4 T cell
CACATAGTCGTACCGG-1	CD4 T cell
CACATTTCACCATGTA-1	Monocyte
CACATTTGTAATTGGA-1	Monocyte
CACATTTGTTGAGTTC-1	CD4 T cell
CACCACTAGTGTACCT-1	CD8 T cell
CACCACTTCCACGTGG-1	Monocyte
CACCTTGAGTGTACGG-1	CD8 T cell
CACCTTGTCCGCGTTT-1	CD4 T cell
CACTCCATCCCTTGCA-1	Monocyte
CAGAATCAGCCGCCTA-1	B cell
CAGAATCCACAGAGGT-1	Monocyte
CAGAATCGTGAAGGCT-1	Monocyte
CAGAATCGTTACGACT-1	CD4 T cell
CAGAATCTCCAGAAGG-1	CD4 T cell
CAGAGAGGTCAGATAA-1	Monocyte
CAGAGAGTCCTTGACC-1	Monocyte
CAGAGAGTCGGAAACG-1	B cell
CAGAGAGTCTTGTACT-1	CD4 T cell
CAGATCAGTAAGAGGA-1	Monocyte
CAGATCAGTAGGGTAC-1	Monocyte
CAGCAGCAGCAGGTCA-1	CD4 T cell
CAGCAGCCATGCATGT-1	NK cell
CAGCAGCGTAGAAAGG-1	Monocyte
CAGCAGCGTGCAACGA-1	CD4 T cell
CAGCAGCTCCGCAAGC-1	CD8 T cell
CAGCATAAGTGGCACA-1	CD8 T cell
CAGCATACAGCCTTGG-1	Monocyte
CAGCCGAAGCTGAACG-1	Dendritic cell
CAGCCGAGTTCTGAAC-1	CD4 T cell
CAGCGACAGTAGTGCG-1	Monocyte
CAGCGACGTAGCGTAG-1	Other
CAGCGACTCGCAGGCT-1	CD4 T cell
CAGCTAACACCTCGTT-1	CD4 T cell
CAGCTAAGTCAGTGGA-1	Monocyte
CAGCTAATCTTGTACT-1	CD8 T cell
CAGCTGGTCTTGTCAT-1	CD8 T cell
CAGTAACGTCCGCTGA-1	NK cell
CAGTAACTCCTACAGA-1	Monocyte
CATATGGCAGTCGTGC-1	Monocyte
CATATGGTCCGATATG-1	CD4 T cell
CATATTCCACCTCGTT-1	CD4 T cell
CATATTCGTCACCCAG-1	B cell
CATCAAGAGACAGAGA-1	CD4 T cell
CATCAGATCAGGTAAA-1	CD8 T cell
CATCAGATCTAACCGA-1	CD4 T cell
CATCCACAGGCGACAT-1	B cell
CATCCACCAGCTGTGC-1	NK cell
CATCCACGTTAAGAAC-1	CD4 T cell
CATCCACTCTGCCAGG-1	CD4 T cell
CATGCCTAGTGCCAGA-1	CD8 T cell
CATGCCTCAGCTATTG-1	B cell
CATGCCTCATCCGGGT-1	B cell
CATGCCTGTTCTCATT-1	CD4 T cell
CATGGCGCAGTTTACG-1	NK cell
CATGGCGTCCGAGCCA-1	Monocyte
CATTATCCACCAACCG-1	B cell
CATTCGCAGGCCCTTG-1	B cell
CCAATCCAGACCTAGG-1	B cell
CCACCTACAGAAGCAC-1	Monocyte
CCACCTACAGCCTGTG-1	CD8 T cell
CCACGGACATTTGCTT-1	Monocyte
CCACGGAGTACAGTGG-1	Monocyte
CCACTACAGACACTAA-1	Monocyte
CCACTACTCCTAAGTG-1	Monocyte
CCACTACTCGTTTATC-1	CD4 T cell
CCAGCGAAGAGTGAGA-1	CD4 T cell
CCATGTCAGGACGAAA-1	Monocyte
CCATGTCCATTGTGCA-1	Monocyte
CCATGTCGTTTGTTTC-1	Other
CCATTCGAGAGACTTA-1	B cell
CCATTCGAGAGCTGCA-1	CD8 T cell
CCCAATCAGTTGTAGA-1	CD8 T cell
CCCAATCTCCTAAGTG-1	B cell
CCCAGTTAGGAGTCTG-1	Monocyte
CCCAGTTAGTCCAGGA-1	CD8 T cell
CCCAGTTCAAGGTTCT-1	B cell
CCCAGTTGTGGACGAT-1	Monocyte
CCCATACAGAAGATTC-1	CD4 T cell
CCCATACAGCACCGCT-1	Monocyte
CCCATACAGTTACGGG-1	Monocyte
CCCATACGTACCGCTG-1	B cell
CCCATACGTGTTTGTG-1	CD4 T cell
CCCTCCTGTGTGCCTG-1	CD8 T cell
CCCTCCTTCGGTCCGA-1	B cell
CCGGGATCAATCACAC-1	CD4 T cell
CCGGGATTCTCGCTTG-1	NK cell
CCGGTAGTCTTCCTTC-1	CD4 T cell
CCGTACTCATGGTCTA-1	CD4 T cell
CCGTACTTCACTTCAT-1	Monocyte
CCGTGGACAAGCGCTC-1	Monocyte
CCGTGGAGTGGCAAAC-1	Monocyte
CCGTTCAAGGCATGTG-1	B cell
CCGTTCACAAGAAAGG-1	B cell
CCGTTCATCGTCGTTC-1	CD8 T cell
CCTAAAGCATGGAATA-1	B cell
CCTAAAGGTGAGGGAG-1	CD8 T cell
CCTAAAGTCATGTCTT-1	CD4 T cell
CCTACACCAGGGAGAG-1	Monocyte
CCTACACGTGCTTCTC-1	CD4 T cell
CCTACACTCAAGAAGT-1	CD4 T cell
CCTACCAAGCCTCGTG-1	CD4 T cell
CCTACCAAGTGGGATC-1	CD4 T cell
CCTACCAGTAAGTGGC-1	NK cell
CCTAGCTAGGCTCATT-1	CD4 T cell
CCTAGCTAGTCAAGCG-1	Monocyte
CCTAGCTGTCACAAGG-1	CD4 T cell
CCTAGCTGTTTGCATG-1	CD4 T cell
CCTAGCTTCGAGAACG-1	NK cell
CCTCTGACAGCAGTTT-1	Monocyte
CCTCTGAGTGCCTGTG-1	B cell
CCTTACGTCCTCAATT-1	Monocyte
CCTTCGACAGTCAGAG-1	Monocyte
CCTTCGATCACATGCA-1	CD8 T cell
CCTTTCTCAACTGGCC-1	Monocyte
CGAACATAGTTCGATC-1	CD8 T cell
CGACCTTAGCCGTCGT-1	CD8 T cell
CGACCTTAGCGATCCC-1	CD4 T cell
CGACCTTTCTGTCAAG-1	Monocyte
CGACTTCAGGACCACA-1	Monocyte
CGACTTCGTTCGAATC-1	B cell
CGACTTCGTTGTGGCC-1	CD8 T cell
CGACTTCTCATATCGG-1	B cell
CGAGAAGGTATTAGCC-1	Monocyte
CGAGAAGGTGAGGGTT-1	CD8 T cell
CGAGAAGTCCGAATGT-1	B cell
CGAGAAGTCTTGCATT-1	CD8 T cell
CGAGCACAGAAGGTTT-1	CD4 T cell
CGAGCACAGTTGTCGT-1	Monocyte
CGAGCACCAACGATGG-1	CD4 T cell
CGAGCACTCAGAAATG-1	B cell
CGAGCCACACCAGCAC-1	CD8 T cell
CGATCGGCATAACCTG-1	Monocyte
CGATGGCGTGCACGAA-1	Monocyte
CGATGGCGTGGTTTCA-1	Monocyte
CGATGTAAGCAGGCTA-1	CD8 T cell
CGATGTAGTTATGTGC-1	CD4 T cell
CGATGTATCCTAGTGA-1	Monocyte
CGCCAAGAGGCGTACA-1	Monocyte
CGCCAAGGTCTAACGT-1	CD4 T cell
CGCGGTAAGGTGCACA-1	Monocyte
CGCGGTACAGTATGCT-1	Other
CGCGGTACATGGATGG-1	B cell
CGCGTTTCACCCATTC-1	Monocyte
CGCTATCGTCAAACTC-1	Monocyte
CGCTGGAAGGAGCGTT-1	Monocyte
CGCTGGAGTAAATACG-1	B cell
CGCTTCAAGTACGCGA-1	Monocyte
CGCTTCAAGTTCGCGC-1	Monocyte
CGCTTCACAATCAGAA-1	CD4 T cell
CGGACACTCTATCCCG-1	Monocyte
CGGACGTTCAGATAAG-1	B cell
CGGACGTTCTCATTCA-1	Monocyte
CGGACGTTCTGTCTCG-1	CD4 T cell
CGGACTGAGGACATTA-1	Monocyte
CGGACTGTCTAACTCT-1	CD4 T cell
CGGAGCTCACGAAGCA-1	Monocyte
CGGAGTCCAGCTGTAT-1	CD4 T cell
CGGAGTCTCAACACCA-1	CD4 T cell
CGGAGTCTCCTGCCAT-1	Monocyte
CGGGTCACAAGCTGAG-1	CD4 T cell
CGGGTCACAGTATCTG-1	Monocyte
CGGGTCAGTCGACTAT-1	CD4 T cell
CGGGTCATCATCGCTC-1	B cell
CGGGTCATCCTATGTT-1	Monocyte
CGGTTAAAGCTAGGCA-1	CD4 T cell
CGGTTAAGTCCTCTTG-1	CD4 T cell
CGGTTAAGTTCAGTAC-1	NK cell
CGGTTAAGTTGTGGCC-1	NK cell
CGGTTAATCACATGCA-1	CD4 T cell
CGGTTAATCCTAGAAC-1	Monocyte
CGTAGCGAGGTGTTAA-1	B cell
CGTAGCGTCCTTTCTC-1	CD4 T cell
CGTAGGCTCCTCCTAG-1	Monocyte
CGTCACTTCGAATGGG-1	CD4 T cell
CGTCAGGGTATATGAG-1	CD4 T cell
CGTCAGGGTGTTTGTG-1	CD8 T cell
CGTCAGGTCCAAAGTC-1	CD8 T cell
CGTCTACAGATCGATA-1	Monocyte
CGTCTACTCCTGCAGG-1	Monocyte
CGTCTACTCTTATCTG-1	B cell
CGTGAGCAGCGCCTTG-1	B cell
CGTGAGCCAAGTTAAG-1	CD8 T cell
CGTGAGCTCAAACAAG-1	Monocyte
CGTGTCTAGACAAGCC-1	Monocyte
CGTGTCTAGACTGTAA-1	CD4 T cell
CGTGTCTAGATAGCAT-1	Monocyte
CGTTAGACAAGGGTCA-1	NK cell
CGTTAGACACGAAGCA-1	CD4 T cell
CGTTAGAGTCAAAGAT-1	Dendritic cell
CGTTCTGGTACATGTC-1	CD4 T cell
CGTTGGGCAATCTACG-1	Monocyte
CGTTGGGGTGAGGCTA-1	NK cell
CTAACTTGTAAACGCG-1	CD4 T cell
CTAACTTGTATGCTTG-1	CD4 T cell
CTAACTTGTTGATTGC-1	CD4 T cell
CTAACTTTCTAACCGA-1	CD4 T cell
CTAAGACCAAAGAATC-1	Monocyte
CTAAGACGTGCTGTAT-1	Monocyte
CTAAGACGTTTGTGTG-1	Monocyte
CTACACCAGCCGATTT-1	Monocyte
CTACACCTCAACTCTT-1	Monocyte
CTACATTAGAAACGCC-1	Monocyte
CTACATTAGGTGACCA-1	CD4 T cell
CTACCCAAGTCCCACG-1	CD4 T cell
CTAGAGTAGACACGAC-1	CD8 T cell
CTAGAGTAGCTAGTTC-1	CD8 T cell
CTAGAGTGTAAACACA-1	CD4 T cell
CTAGAGTGTCGCGAAA-1	CD4 T cell
CTAGAGTGTTCGAATC-1	Monocyte
CTAGCCTAGGAGTTTA-1	CD4 T cell
CTAGTGAAGCTCCTTC-1	Monocyte
CTAGTGAGTAGCGATG-1	Monocyte
CTCACACCAGACTCGC-1	Monocyte
CTCACACGTGCTTCTC-1	CD8 T cell
CTCAGAATCCTATGTT-1	NK cell
CTCAGAATCGGATGGA-1	CD4 T cell
CTCATTAAGGAGTTGC-1	B cell
CTCATTATCTAGAGTC-1	CD8 T cell
CTCCTAGCATTATCTC-1	NK cell
CTCCTAGTCACGCATA-1	CD4 T cell
CTCGAGGAGCTAACAA-1	NK cell
CTCGAGGGTCGGCTCA-1	CD8 T cell
CTCGGAGAGCTGAAAT-1	Monocyte
CTCGGAGTCTTAGAGC-1	CD4 T cell
CTCGGGACACACGCTG-1	CD8 T cell
CTCGGGATCGTAGGAG-1	CD4 T cell
CTCGTACAGGTAAACT-1	CD4 T cell
CTCGTACTCTTTACGT-1	Monocyte
CTCGTCAGTTGAGGTG-1	B cell
CTCGTCAGTTGTACAC-1	Other
CTCTAATAGCTAGTCT-1	Monocyte
CTCTAATCAGCCTTTC-1	Monocyte
CTCTAATGTCCAGTTA-1	CD4 T cell
CTCTACGAGCGTTTAC-1	CD8 T cell
CTCTACGTCAACTCTT-1	CD8 T cell
CTCTACGTCGACGGAA-1	CD8 T cell
CTCTGGTAGAGTGACC-1	CD8 T cell
CTCTGGTTCTGGTTCC-1	Monocyte
CTGAAGTCAATTGCTG-1	Monocyte
CTGAAGTCACCAGCAC-1	Monocyte
CTGAAGTGTATAATGG-1	CD4 T cell
CTGAAGTGTGTCGCTG-1	NK cell
CTGAAGTTCATAACCG-1	CD4 T cell
CTGATAGCACCCTATC-1	Monocyte
CTGATAGTCGTTTAGG-1	NK cell
CTGATCCAGCAGCGTA-1	CD8 T cell
CTGATCCAGTAGCGGT-1	CD4 T cell
CTGATCCTCGTCACGG-1	CD8 T cell
CTGCCTAAGAAACCAT-1	B cell
CTGCCTAGTTCGTGAT-1	Monocyte
CTGCCTATCCTACAGA-1	B cell
CTGCGGAAGACTAGAT-1	Monocyte
CTGCGGACATCATCCC-1	CD8 T cell
CTGCTGTAGAGACTAT-1	Monocyte
CTGCTGTAGCAGGTCA-1	Monocyte
CTGCTGTCAAGGTTCT-1	B cell
CTGCTGTCATTATCTC-1	CD4 T cell
CTGCTGTGTGTCTGAT-1	Monocyte
CTGCTGTTCAACTCTT-1	B cell
CTGGTCTCATCTCCCA-1	Monocyte
CTGGTCTTCATAAAGG-1	B cell
CTGGTCTTCATCGCTC-1	Dendritic cell
CTGTGCTAGCAGGTCA-1	CD8 T cell
CTGTGCTCAAGTAATG-1	Monocyte
CTGTGCTCATATACGC-1	NK cell
CTGTGCTGTGCCTTGG-1	CD4 T cell
CTGTTTAAGGGATGGG-1	CD8 T cell
CTTACCGAGCCACGTC-1	CD4 T cell
CTTACCGGTGGACGAT-1	NK cell
CTTACCGTCTTGTATC-1	NK cell
CTTAGGACAAACCTAC-1	Monocyte
CTTAGGACATACCATG-1	CD4 T cell
CTTCTCTAGATGGCGT-1	Monocyte
CTTCTCTTCAGAAATG-1	Monocyte
CTTGGCTAGTCAAGGC-1	CD8 T cell
CTTGGCTGTTGTACAC-1	Monocyte
CTTGGCTTCACCGGGT-1	Monocyte
CTTGGCTTCTGTTTGT-1	Monocyte
CTTTGCGAGATCCTGT-1	CD4 T cell
CTTTGCGGTTTAAGCC-1	CD4 T cell
CTTTGCGGTTTGACAC-1	CD4 T cell
CTTTGCGTCGCGATCG-1	CD4 T cell
GAAACTCTCACCCGAG-1	CD4 T cell
GAAATGATCTCCTATA-1	CD8 T cell
GAACATCCAGTTCCCT-1	B cell
GAACCTATCTGGTGTA-1	CD4 T cell
GAACGGAAGGAGCGAG-1	Monocyte
GAAGCAGAGGACCACA-1	CD8 T cell
GAATAAGCAACACGCC-1	Monocyte
GAATAAGGTCAAAGAT-1	B cell
GAATAAGTCTATCCTA-1	Monocyte
GAATGAAAGAAAGTGG-1	Monocyte
GAATGAATCATCACCC-1	CD8 T cell
GACCAATCAATAACGA-1	Monocyte
GACCAATCAGCTGGCT-1	CD4 T cell
GACCAATGTCATGCAT-1	Dendritic cell
GACCAATGTCGCGTGT-1	CD8 T cell
GACCTGGAGAGGTTAT-1	B cell
GACCTGGGTCTCATCC-1	NK cell
GACCTGGTCAACTCTT-1	Monocyte
GACCTGGTCTAACCGA-1	Other
GACGCGTTCCGATATG-1	Monocyte
GACGCGTTCTCTAAGG-1	NK cell
GACGGCTAGCGCTTAT-1	CD4 T cell
GACGGCTCATGATCCA-1	CD8 T cell
GACGGCTGTAAGGGCT-1	CD8 T cell
GACGGCTGTGGTCTCG-1	Monocyte
GACGTGCCAGCTGTGC-1	Monocyte
GACGTGCCATACGCTA-1	CD4 T cell
GACTACACAATGAAAC-1	CD8 T cell
GACTGCGCAATGGACG-1	B cell
GACTGCGCATCTACGA-1	CD4 T cell
GACTGCGGTCGGCACT-1	Dendritic cell
GAGCAGAGTGTGCCTG-1	B cell
GAGTCCGAGGATGGAA-1	CD8 T cell
GAGTCCGGTCGGCATC-1	CD4 T cell
GAGTCCGTCCAAGTAC-1	Monocyte
GATCAGTGTGACAAAT-1	Monocyte
GATCAGTTCGCGATCG-1	Monocyte
GATCGATGTGTTAAGA-1	CD4 T cell
GATCGCGTCGTAGGTT-1	B cell
GATCGTACACGGCTAC-1	Monocyte
GATCGTAGTTGCTCCT-1	Other
GATCGTATCCATGAGT-1	CD4 T cell
GATCTAGCACCACCAG-1	Monocyte
GATCTAGGTCTAGCGC-1	CD4 T cell
GATGAAATCACAACGT-1	B cell
GATGCTAAGTGACATA-1	Monocyte
GATGCTAGTATATGGA-1	CD4 T cell
GATTCAGAGCCCTAAT-1	Monocyte
GATTCAGAGCGCTCCA-1	Monocyte
GATTCAGCATGCGCAC-1	CD4 T cell
GCAAACTAGAGGGCTT-1	CD4 T cell
GCAAACTGTGTCAATC-1	CD4 T cell
GCAAACTTCTGCGTAA-1	CD8 T cell
GCAAACTTCTGGAGCC-1	Monocyte
GCAATCAAGAGGTAGA-1	B cell
GCACTCTAGAATTGTG-1	CD4 T cell
GCACTCTAGCACAGGT-1	CD8 T cell
GCACTCTGTATAATGG-1	CD4 T cell
GCAGCCACAGGACCCT-1	Monocyte
GCAGCCATCCTCAATT-1	Monocyte
GCATGATGTCAACATC-1	NK cell
GCATGATTCGCCTGAG-1	Monocyte
GCATGATTCGTTGACA-1	CD4 T cell
GCATGTAAGATCCCGC-1	Monocyte
GCATGTACACAGCGTC-1	B cell
GCATGTACATTCGACA-1	Other
GCATGTAGTTCAACCA-1	Monocyte
GCATGTAGTTGCCTCT-1	CD4 T cell
GCCAAATGTGAAGGCT-1	Monocyte
GCGACCACAGACAAAT-1	CD4 T cell
GCGACCAGTTAAGACA-1	B cell
GCGACCATCAGCCTAA-1	Monocyte
GCGACCATCTCGATGA-1	Monocyte
GCGAGAAAGCTAGGCA-1	Monocyte
GCGAGAAAGTATCTCG-1	B cell
GCGAGAACAGATGGGT-1	CD4 T cell
GCGAGAAGTACATGTC-1	NK cell
GCGAGAAGTGTAAGTA-1	B cell
GCGCAACAGAGTACAT-1	B cell
GCGCAACCACCTGGTG-1	Dendritic cell
GCGCAACCAGATGGCA-1	Monocyte
GCGCAACTCGTCACGG-1	Monocyte
GCGCAGTAGGAGTACC-1	CD4 T cell
GCGCAGTGTGCCTGGT-1	Monocyte
GCGCAGTGTTCGCTAA-1	CD4 T cell
GCGCAGTGTTTGTGTG-1	Monocyte
GCGCAGTTCAACACGT-1	B cell
GCGCCAAAGGGCTCTC-1	B cell
GCGCCAACACAGACTT-1	CD4 T cell
GCGCCAATCAGGTTCA-1	CD4 T cell
GCGCGATAGGATGGAA-1	B cell
GCGCGATCAGACTCGC-1	CD4 T cell
GCGCGATGTAGCTTGT-1	CD4 T cell
GCGGGTTCATCCCATC-1	CD8 T cell
GCGGGTTCATCCGTGG-1	CD4 T cell
GCGGGTTTCGTTTATC-1	CD8 T cell
GCTCCTATCAATCACG-1	B cell
GCTCTGTGTCTCTCTG-1	NK cell
GCTCTGTGTGCCTGGT-1	CD4 T cell
GCTCTGTTCTGCTGCT-1	Monocyte
GCTGCAGTCGCTAGCG-1	CD8 T cell
GCTGCAGTCTGAGTGT-1	B cell
GCTGCGACAGCCACCA-1	CD4 T cell
GCTGCGATCAGAGACG-1	CD8 T cell
GCTGCGATCCATGAGT-1	B cell
GCTGCTTAGCGATGAC-1	CD8 T cell
GCTTCCAAGCAGGCTA-1	CD4 T cell
GCTTCCAGTGCAGTAG-1	Monocyte
GCTTGAAAGAAGGACA-1	CD8 T cell
GGAATAAAGGAGTACC-1	Monocyte
GGAATAACACATCCAA-1	NK cell
GGAATAACACCAGGTC-1	CD4 T cell
GGAATAAGTAAACGCG-1	NK cell
GGACAAGAGAATTGTG-1	NK cell
GGACAAGAGTACGCCC-1	CD8 T cell
GGACAAGAGTGTTGAA-1	CD4 T cell
GGACAAGCATACGCTA-1	Monocyte
GGACATTCACTGCCAG-1	B cell
GGACATTTCACAGTAC-1	Dendritic cell
GGACGTCTCGAGCCCA-1	B cell
GGAGCAAAGATCACGG-1	Monocyte
GGATGTTCATGTAGTC-1	CD4 T cell
GGATGTTTCCACTGGG-1	CD4 T cell
GGATGTTTCTGGAGCC-1	Monocyte
GGATTACAGATGAGAG-1	Monocyte
GGCAATTCACCATCCT-1	CD4 T cell
GGCAATTGTCGATTGT-1	NK cell
GGCAATTGTCTGGTCG-1	B cell
GGCCGATGTAGGAGTC-1	CD4 T cell
GGCCGATTCAGTACGT-1	Monocyte
GGCGACTTCAACACCA-1	CD8 T cell
GGCGTGTTCCACGACG-1	CD4 T cell
GGCGTGTTCCCGGATG-1	Monocyte
GGCTCGAGTATTCTCT-1	Monocyte
GGCTGGTGTAATCGTC-1	CD4 T cell
GGCTGGTGTCGAGTTT-1	Monocyte
GGCTGGTGTCTAGGTT-1	Monocyte
GGCTGGTTCTCGTTTA-1	Monocyte
GGGAATGAGCTGATAA-1	Monocyte
GGGAATGAGGGTTTCT-1	Dendritic cell
GGGAATGCAGCTGTTA-1	Monocyte
GGGACCTCAGTCGATT-1	CD4 T cell
GGGACCTTCGGAGGTA-1	CD4 T cell
GGGAGATCAGTGAGTG-1	CD8 T cell
GGGAGATGTCTTGTCC-1	CD4 T cell
GGGAGATTCACCGGGT-1	CD8 T cell
GGGATGAAGGTGATAT-1	Monocyte
GGGATGAGTGCAGACA-1	CD4 T cell
GGGCACTCAGTCAGCC-1	Monocyte
GGGCACTTCAATCTCT-1	Monocyte
GGGTCTGAGCTGCCCA-1	Monocyte
GGGTCTGGTAATAGCA-1	Monocyte
GGTATTGGTTCACCTC-1	Monocyte
GGTGAAGTCGTTACAG-1	CD8 T cell
GGTGCGTTCAGCTCGG-1	B cell
GGTGCGTTCGCTAGCG-1	Monocyte
GGTGTTAAGCGATTCT-1	NK cell
GGTGTTACACCACGTG-1	CD8 T cell
GGTGTTATCACTATTC-1	Monocyte
GGTGTTATCACTTATC-1	B cell
GTAACGTCATTGGTAC-1	CD8 T cell
GTAACGTTCTGGTATG-1	Monocyte
GTAACTGTCACCTTAT-1	CD4 T cell
GTACGTAGTATCAGTC-1	CD4 T cell
GTACTCCCACAGACAG-1	B cell
GTACTTTGTCGGCACT-1	NK cell
GTACTTTGTCTGCAAT-1	CD4 T cell
GTAGGCCCACTGCCAG-1	NK cell
GTAGTCAAGATGTAAC-1	NK cell
GTAGTCATCCGAGCCA-1	Monocyte
GTATCTTAGACGCTTT-1	CD4 T cell
GTATCTTGTAACGTTC-1	CD4 T cell
GTATCTTTCCTCAACC-1	B cell
GTATCTTTCCTTTACA-1	CD4 T cell
GTATTCTAGGTTCCTA-1	CD4 T cell
GTATTCTTCTCCGGTT-1	B cell
GTCAAGTCAGCATACT-1	CD4 T cell
GTCAAGTTCCTTTCTC-1	CD4 T cell
GTCAAGTTCGGGAGTA-1	CD8 T cell
GTCACAAAGCGATATA-1	Other
GTCACAAGTCTTGATG-1	Monocyte
GTCACAATCTCAACTT-1	CD8 T cell
GTCACGGAGCACACAG-1	CD4 T cell
GTCACGGGTGCTTCTC-1	CD4 T cell
GTCATTTAGGGATCTG-1	Monocyte
GTCATTTTCATGTAGC-1	NK cell
GTCATTTTCTATCGCC-1	Monocyte
GTCCTCAAGCTCCCAG-1	CD8 T cell
GTCCTCATCGACCAGC-1	CD4 T cell
GTCGGGTCAGTGACAG-1	CD4 T cell
GTCGGGTCATGCATGT-1	CD4 T cell
GTCGGGTCATTACCTT-1	CD4 T cell
GTCGGGTGTCGAGATG-1	Other
GTCTCGTGTCAAAGAT-1	CD4 T cell
GTCTCGTTCAGTTTGG-1	Monocyte
GTCTCGTTCCAACCAA-1	Monocyte
GTCTTCGGTCTGCAAT-1	CD4 T cell
GTCTTCGTCCACGTGG-1	CD8 T cell
GTGAAGGCAGCTGTAT-1	Monocyte
GTGCAGCCATTTGCTT-1	B cell
GTGCAGCTCTTCATGT-1	CD4 T cell
GTGCATAAGGAGCGTT-1	Monocyte
GTGCGGTAGCTACCGC-1	CD4 T cell
GTGCGGTAGGCCGAAT-1	B cell
GTGCGGTCATGCCACG-1	Monocyte
GTGCGGTCATTGTGCA-1	Monocyte
GTGCGGTTCAGTTTGG-1	CD8 T cell
GTGCTTCAGATGAGAG-1	CD4 T cell
GTGCTTCGTATGAATG-1	CD4 T cell
GTGGGTCAGATGCGAC-1	B cell
GTGGGTCAGTGGGTTG-1	CD8 T cell
GTGGGTCCATCGGGTC-1	CD4 T cell
GTGGGTCGTTCGAATC-1	Monocyte
GTGTGCGGTATGCTTG-1	Monocyte
GTTAAGCAGCCACCTG-1	B cell
GTTAAGCCAATTGCTG-1	Monocyte
GTTACAGCACTTACGA-1	Monocyte
GTTACAGGTCAGGACA-1	CD4 T cell
GTTCATTGTGTAACGG-1	CD8 T cell
GTTCGGGCAGACAAGC-1	Dendritic cell
GTTCGGGGTAGCGATG-1	Monocyte
GTTCGGGTCATAGCAC-1	Monocyte
GTTCGGGTCGAATCCA-1	Monocyte
GTTCTCGTCATAAAGG-1	CD4 T cell
GTTCTCGTCTAACTGG-1	Monocyte
GTTTCTAGTACTTGAC-1	CD4 T cell
GTTTCTATCGTTGACA-1	Monocyte
TAAACCGCAAGGACAC-1	CD4 T cell
TAAACCGCATACGCCG-1	NK cell
TAAACCGCATGGTAGG-1	B cell
TAAGAGAGTTGAACTC-1	B cell
TAAGCGTAGCTCCTCT-1	B cell
TAAGCGTGTCTTGCGG-1	Monocyte
TAAGTGCGTAGCGTGA-1	Monocyte
TAAGTGCTCTCTAAGG-1	CD4 T cell
TAAGTGCTCTGCTGCT-1	B cell
TACACGATCGTGGGAA-1	NK cell
TACAGTGAGTGTCCCG-1	CD8 T cell
TACAGTGCAGCTCGCA-1	CD8 T cell
TACAGTGCAGGTGCCT-1	Monocyte
TACAGTGGTTCTCATT-1	Monocyte
TACCTATAGAGTTGGC-1	NK cell
TACCTATAGCAGCGTA-1	Monocyte
TACCTATAGTATTGGA-1	CD8 T cell
TACCTATGTCAACTGT-1	Monocyte
TACCTTACAAGTTGTC-1	Monocyte
TACGGATCAAACGTGG-1	Monocyte
TACGGATCAGCTATTG-1	CD4 T cell
TACGGGCCACAACGTT-1	B cell
TACGGTAAGGATGCGT-1	NK cell
TACGGTAGTCCCGACA-1	Monocyte
TACGGTAGTCTCTTTA-1	B cell
TACTCATAGAGACGAA-1	CD4 T cell
TACTCGCCAGCTCCGA-1	CD8 T cell
TACTTACAGGCTATCT-1	Monocyte
TACTTACCACCTTGTC-1	Monocyte
TACTTGTCACATAACC-1	CD4 T cell
TAGAGCTAGCCAACAG-1	Monocyte
TAGAGCTCAGGGTATG-1	CD4 T cell
TAGCCGGCAGGGTTAG-1	Monocyte
TAGCCGGGTATAGGGC-1	B cell
TAGGCATGTTCCTCCA-1	CD4 T cell
TAGTGGTCAGGGTTAG-1	Monocyte
TATCAGGAGATCACGG-1	B cell
TATCAGGTCAGTCAGT-1	CD4 T cell
TATGCCCCAATGTAAG-1	B cell
TATGCCCGTACTTAGC-1	CD8 T cell
TATGCCCGTTCCGGCA-1	CD4 T cell
TATGCCCTCATTCACT-1	CD4 T cell
TATTACCAGGGCTTCC-1	CD8 T cell
TCAACGAAGCTAGTGG-1	CD8 T cell
TCAACGAGTTAAGACA-1	CD8 T cell
TCAATCTAGGATGCGT-1	B cell
TCAATCTGTACACCGC-1	Monocyte
TCACAAGAGGACAGCT-1	CD4 T cell
TCACAAGCATCCTTGC-1	Monocyte
TCACAAGGTGAGTATA-1	Monocyte
TCACAAGTCCAGAAGG-1	Monocyte
TCACGAAGTTACCAGT-1	B cell
TCACGAATCACTCCTG-1	CD4 T cell
TCAGATGTCGTTGCCT-1	CD8 T cell
TCAGCAATCAGCACAT-1	Monocyte
TCAGCTCCACGCATCG-1	B cell
TCAGGATCAGGTCGTC-1	CD4 T cell
TCAGGATGTATAGGGC-1	CD8 T cell
TCAGGATGTCATGCCG-1	CD8 T cell
TCAGGATTCGCAGGCT-1	CD4 T cell
TCAGGTATCGCCAGCA-1	CD4 T cell
TCATTACTCAGCATGT-1	NK cell
TCATTTGAGCTCTCGG-1	CD4 T cell
TCCACACAGCGCCTCA-1	CD4 T cell
TCCACACGTACAGACG-1	CD4 T cell
TCCCGATAGGCCCGTT-1	CD8 T cell
TCCCGATTCACAACGT-1	NK cell
TCGAGGCGTTACGACT-1	Monocyte
TCGCGAGGTTATCACG-1	Monocyte
TCGCGAGGTTCCAACA-1	CD4 T cell
TCGCGAGGTTGTCTTT-1	CD4 T cell
TCGGGACTCGCAAACT-1	CD4 T cell
TCGGTAAGTCTGCGGT-1	CD4 T cell
TCGGTAATCAACACCA-1	B cell
TCGTACCAGGCTCAGA-1	B cell
TCGTACCAGTGGGCTA-1	Monocyte
TCGTACCCATAGAAAC-1	NK cell
TCGTAGAGTCTTGTCC-1	CD4 T cell
TCTATTGAGAGTGAGA-1	CD4 T cell
TCTATTGCATGCCTAA-1	CD4 T cell
TCTATTGGTGTCAATC-1	Monocyte
TCTCATAGTACCGGCT-1	Monocyte
TCTCATAGTTCCACTC-1	CD4 T cell
TCTCTAACAGATCCAT-1	CD4 T cell
TCTGAGAAGTACTTGC-1	CD8 T cell
TCTGAGAAGTGTACTC-1	CD4 T cell
TCTGAGACAGGCGATA-1	CD4 T cell
TCTGAGACATAGACTC-1	CD8 T cell
TCTGAGATCTATGTGG-1	Monocyte
TCTGGAATCAGGCGAA-1	CD4 T cell
TCTTTCCTCCACTCCA-1	CD4 T cell
TGAAAGAAGGATTCGG-1	Monocyte
TGAAAGAAGTCTCAAC-1	CD8 T cell
TGAAAGATCCAAATGC-1	CD8 T cell
TGACAACAGTGAATTG-1	CD4 T cell
TGACAACTCTACTTAC-1	CD4 T cell
TGACGGCAGATACACA-1	Monocyte
TGACGGCGTGATGTCT-1	Monocyte
TGACTAGGTCAGAAGC-1	Monocyte
TGACTAGGTTCGGGCT-1	Monocyte
TGACTAGTCACATACG-1	CD4 T cell
TGACTAGTCTCTTATG-1	B cell
TGACTTTAGGCTCAGA-1	CD4 T cell
TGACTTTCATTGGCGC-1	CD4 T cell
TGAGAGGCATGTCGAT-1	B cell
TGAGCATGTCCCGACA-1	CD4 T cell
TGAGCCGAGCGAAGGG-1	CD8 T cell
TGAGCCGCAGTCACTA-1	CD4 T cell
TGAGGGAAGAGACTTA-1	CD8 T cell
TGAGGGAAGTACTTGC-1	CD4 T cell
TGAGGGACATCCAACA-1	Monocyte
TGAGGGAGTCTAACGT-1	NK cell
TGATTTCAGATCGGGT-1	CD4 T cell
TGCACCTAGCTAGTCT-1	B cell
TGCACCTCACACTGCG-1	NK cell
TGCACCTCATGCAATC-1	B cell
TGCACCTTCAGGCAAG-1	CD4 T cell
TGCCAAACAAACCTAC-1	CD4 T cell
TGCCAAAGTGTGAATA-1	Monocyte
TGCCAAATCGAATCCA-1	CD4 T cell
TGCCCTAAGTGTACTC-1	Monocyte
TGCGCAGAGGAGTTTA-1	NK cell
TGCGCAGCACATTAGC-1	Monocyte
TGCGCAGCATCGGAAG-1	Monocyte
TGCGCAGGTGGGTATG-1	CD4 T cell
TGCGTGGGTCTCCACT-1	CD4 T cell
TGCTACCCATGACGGA-1	CD4 T cell
TGCTACCTCGGCTACG-1	B cell
TGCTACCTCGTATCAG-1	Monocyte
TGCTGCTAGCCTATGT-1	Monocyte
TGCTGCTAGTGAAGTT-1	CD8 T cell
TGCTGCTGTTATTCTC-1	NK cell
TGCTGCTGTTCGGCAC-1	CD4 T cell
TGCTGCTTCAAAGTAG-1	B cell
TGGACGCAGACCACGA-1	Monocyte
TGGACGCCAGAGTGTG-1	CD4 T cell
TGGACGCGTTAGTGGG-1	Monocyte
TGGACGCTCATGTCCC-1	CD4 T cell
TGGCGCACAGATGGGT-1	Monocyte
TGGCTGGCAAGGTGTG-1	Monocyte
TGGCTGGCACCCATTC-1	Dendritic cell
TGGCTGGTCAGTTCGA-1	CD4 T cell
TGGCTGGTCGTTTATC-1	B cell
TGGGAAGCATCCCATC-1	CD4 T cell
TGGGAAGTCGAACGGA-1	CD4 T cell
TGGGCGTTCGTAGATC-1	CD4 T cell
TGGTTAGAGAAGGACA-1	NK cell
TGGTTAGGTAATAGCA-1	NK cell
TGGTTAGTCAACACAC-1	CD4 T cell
TGGTTAGTCACAATGC-1	CD8 T cell
TGGTTCCAGCTCCCAG-1	B cell
TGGTTCCAGTATTGGA-1	Monocyte
TGGTTCCCAAGCCGCT-1	NK cell
TGGTTCCCAGTCACTA-1	CD4 T cell
TGGTTCCCATCGTCGG-1	Other
TGGTTCCGTATTACCG-1	B cell
TGTATTCCATTGGGCC-1	CD8 T cell
TGTATTCGTAGCGTGA-1	CD8 T cell
TGTCCCATCAACACTG-1	CD4 T cell
TGTCCCATCTGTCAAG-1	B cell
TGTGGTAAGGGCATGT-1	B cell
TGTGGTACAGTACACT-1	Monocyte
TGTGGTATCCACTGGG-1	CD8 T cell
TGTGTTTCAGCTTAAC-1	Monocyte
TGTGTTTGTTATGTGC-1	CD8 T cell
TTAACTCCAACACCTA-1	Monocyte
TTAGGACCAGCCTTTC-1	CD4 T cell
TTAGGACGTCTTTCAT-1	CD4 T cell
TTAGGCAGTAAGGGAA-1	CD4 T cell
TTAGTTCAGGGCTTGA-1	NK cell
TTAGTTCCAAGTAGTA-1	CD8 T cell
TTATGCTAGTATGACA-1	B cell
TTATGCTCACCAACCG-1	Dendritic cell
TTATGCTGTCTCTCGT-1	Monocyte
TTATGCTTCCACGTTC-1	CD4 T cell
TTATGCTTCCCTTGTG-1	Monocyte
TTCCCAGAGCGTCAAG-1	CD4 T cell
TTCCCAGTCTTGCATT-1	CD4 T cell
TTCGGTCAGCTAAACA-1	B cell
TTCGGTCCAATCAGAA-1	CD8 T cell
TTCGGTCGTAAATGAC-1	B cell
TTCGGTCGTAAGGATT-1	CD4 T cell
TTCTACAAGCATGGCA-1	CD4 T cell
TTCTACATCCCAGGTG-1	NK cell
TTCTACATCGCCCTTA-1	Monocyte
TTCTCAAAGCTACCTA-1	CD4 T cell
TTCTCAAGTGACAAAT-1	Monocyte
TTCTCAATCCACGTTC-1	CD8 T cell
TTCTCAATCCTTTCGG-1	Monocyte
TTCTCAATCGCCTGAG-1	CD4 T cell
TTCTCCTTCGCCAAAT-1	B cell
TTCTTAGCAAAGTCAA-1	Monocyte
TTCTTAGTCAGCTCGG-1	CD4 T cell
TTGAACGAGCTTCGCG-1	Monocyte
TTGAACGCACGAAAGC-1	B cell
TTGAACGTCCTATTCA-1	Monocyte
TTGCCGTTCACCAGGC-1	Monocyte
TTGCGTCAGGTGCTAG-1	Monocyte
TTGCGTCCAACACCTA-1	Monocyte
TTGCGTCCACAGGAGT-1	CD4 T cell
TTGCGTCGTTATTCTC-1	CD8 T cell
TTGGAACGTGCGCTTG-1	Monocyte
TTGGAACTCGAGCCCA-1	B cell
TTGGCAAAGTCTCGGC-1	Monocyte
TTGGCAATCTGTTTGT-1	Monocyte
TTGTAGGCACTAAGTC-1	Monocyte
TTGTAGGTCGGATGTT-1	CD8 T cell
TTTACTGAGGCTAGGT-1	CD4 T cell
TTTACTGCAGTGGAGT-1	Monocyte
TTTATGCCAAGCCTAT-1	NK cell
TTTATGCCAATCACAC-1	CD4 T cell
TTTCCTCCACTTGGAT-1	B cell
TTTCCTCCATCTCGCT-1	CD4 T cell
TTTGCGCTCAGGCAAG-1	Monocyte
TTTGGTTAGAGTAAGG-1	B cell
TTTGGTTAGCACCGTC-1	B cell
TTTGGTTAGTGGGCTA-1	B cell
TTTGTCAAGCATGGCA-1	Monocyte
TTTGTCAAGGCCGAAT-1	Monocyte
TTTGTCACATGTAAGA-1	Monocyte
