cell	celltype
AAACCCAAGTGGTCAG-1	B cell
AAAGGTATCAACTACG-1	CD4 T cell
AAAGTCCAGCGTGTCC-1	CD4 T cell
AACACACTCAAGAGTA-1	B cell
AACACACTCGACGAGA-1	Monocyte
AACAGGGCAGGAGGTT-1	Monocyte
AACAGGGCAGTGTATC-1	Monocyte
AACAGGGTCAGAATAG-1	Dendritic cell
AACCTGAAGATGGTCG-1	CD8 T cell
AACGGGATCGTTATCT-1	CD4 T cell
AACTTCTAGATGCAGC-1	Monocyte
AACTTCTGTATCATGC-1	CD8 T cell
AACTTCTGTGCGCTCA-1	CD4 T cell
AAGAACAGTGAGACCA-1	CD4 T cell
AAGAACATCCATACAG-1	B cell
AAGACTCTCGACCACG-1	Monocyte
AAGATAGCAGGCATGA-1	Monocyte
AAGCATCTCGTGAGAG-1	Monocyte
AAGCGAGAGCAACAGC-1	Monocyte
AAGCGAGAGCCAAGGT-1	Other
AAGCGAGCACACAGAG-1	Monocyte
AAGCGAGCAGAGGCAT-1	NK cell
AAGCGTTAGAGGACTC-1	Other
AAGTCGTAGCTGGCTC-1	CD8 T cell
AAGTTCGGTAGAGACC-1	Monocyte
AATCGACAGTACAACA-1	Monocyte
AATCGACAGTCAAGCG-1	CD4 T cell
AATGAAGTCTGGAGAG-1	B cell
AATGACCTCCAACCAA-1	CD8 T cell
AATGGCTGTATGGGAC-1	CD4 T cell
AATGGCTGTCTGATCA-1	CD8 T cell
AATGGCTTCAGAGTTC-1	B cell
AATTCCTCAATACCTG-1	CD4 T cell
AATTCCTGTATGAAGT-1	Monocyte
AATTCCTGTTTACGTG-1	Other
ACAAAGACACAATGAA-1	NK cell
ACAACCACATCGTGCG-1	Monocyte
ACAACCAGTCTGTGGC-1	B cell
ACACTGAAGCATCAAA-1	Other
ACAGCCGGTGCTGTCG-1	Monocyte
ACATCCCAGGCCTTCG-1	NK cell
ACATCGAGTGATTCTG-1	CD8 T cell
ACATGCAAGGTGCTGA-1	Monocyte
ACATTTCAGTCTAACC-1	CD4 T cell
ACATTTCTCGCGAAGA-1	CD4 T cell
ACCAAACCAAATGGCG-1	B cell
ACCAACATCTAATTCC-1	CD4 T cell
ACCCTCACACAAGCCC-1	CD8 T cell
ACCCTCAGTTGAGGAC-1	CD4 T cell
ACCTACCAGTCCTACA-1	B cell
ACCTGTCAGTTCGGTT-1	B cell
ACCTGTCCAGACCTAT-1	Other
ACCTGTCGTGATTAGA-1	Monocyte
ACGATCAAGGCTAGCA-1	CD4 T cell
ACGCACGAGGAGTCTG-1	Monocyte
ACGGAAGAGAGTAACT-1	Monocyte
ACGGAAGTCAAGCGTT-1	CD8 T cell
ACGTAACTCATTACGG-1	Monocyte
ACGTAGTAGAGAGGGC-1	Other
ACGTAGTGTTGACTAC-1	B cell
ACGTCCTAGAGAAGGT-1	CD8 T cell
ACGTCCTGTCGTTGCG-1	CD4 T cell
ACGTTCCCATTCGGGC-1	CD8 T cell
ACGTTCCGTAGATCCT-1	CD8 T cell
ACTACGAAGAGTATAC-1	B cell
ACTATCTGTGCAATAA-1	CD8 T cell
ACTATCTTCCGTGTGG-1	Monocyte
ACTATCTTCCTTGGAA-1	Other
ACTATGGGTAGAGCTG-1	Monocyte
ACTCCCATCCGACAGC-1	Monocyte
ACTTATCTCATACAGC-1	CD4 T cell
ACTTCCGCAGTTCACA-1	CD4 T cell
ACTTTCAGTCACCCTT-1	Other
AGAAATGTCGCGTTTC-1	Monocyte
AGAACAAAGCTGCCTG-1	Monocyte
AGAACCTGTTACGGAG-1	CD8 T cell
AGACACTAGAGATGCC-1	Monocyte
AGACACTAGATGCCGA-1	CD8 T cell
AGACCATGTGTGAATA-1	CD4 T cell
AGACTCACATTCAGGT-1	NK cell
AGACTCATCGCCAGAC-1	CD4 T cell
AGAGAGCCAAGTAGTA-1	Monocyte
AGATCCAAGTAGAGTT-1	Monocyte
AGATCGTTCGAACGGA-1	Monocyte
AGATGCTCACAACGAG-1	CD4 T cell
AGCGCCAAGGCAGGTT-1	Monocyte
AGCGTCGGTAGTTAGA-1	Other
AGCTACAAGCGGTAAC-1	Monocyte
AGCTACACAATCGAAA-1	B cell
AGCTACACATCCTCAC-1	B cell
AGCTACAGTGAGTAGC-1	Other
AGCTTCCAGCTTGTGT-1	Monocyte
AGGAATACATAGAAAC-1	Monocyte
AGGACGAGTAAGGTCG-1	Monocyte
AGGAGGTAGGACTTCT-1	CD4 T cell
AGGAGGTGTGACCGAA-1	CD4 T cell
AGGAGGTTCATCGCTC-1	B cell
AGGATAAAGTTCATCG-1	Other
AGGATAAGTGGCAACA-1	CD4 T cell
AGGATCTGTTCGGACC-1	CD4 T cell
AGGCTGCGTCAACGCC-1	Other
AGGGAGTGTTACGTAC-1	CD4 T cell
AGGGCCTTCCATATGG-1	CD4 T cell
AGGGCCTTCGAAATCC-1	Monocyte
AGGGTGAGTCTCACAA-1	CD4 T cell
AGGTAGGCAAGGCGTA-1	Monocyte
AGGTAGGGTACCGGAA-1	CD4 T cell
AGTAACCTCTACGGGC-1	Monocyte
AGTACCACACAATTCG-1	CD4 T cell
AGTAGTCCACTGCGTG-1	Monocyte
AGTGTTGAGCCAGTAG-1	Monocyte
AGTTAGCCACTTCATT-1	CD8 T cell
AGTTCCCCAATCGTCA-1	B cell
AGTTCCCTCCTCAGAA-1	CD4 T cell
AGTTCGAAGTAAGACT-1	CD4 T cell
AGTTCGATCGTGAGAG-1	Monocyte
ATACCGAAGCAAACAT-1	NK cell
ATACCGAGTTGTTTGG-1	Monocyte
ATAGACCAGCGAATGC-1	Other
ATAGACCTCTGGGCGT-1	B cell
ATAGAGAGTCACCCTT-1	Monocyte
ATAGAGATCAGACATC-1	Monocyte
ATAGGCTTCAGCCCAG-1	Monocyte
ATATCCTAGTCTCGTA-1	CD4 T cell
ATCACGACAAGTAGTA-1	CD4 T cell
ATCATTCTCAACGCTA-1	B cell
ATCCTATCATGACACT-1	Other
ATCCTATGTCACATTG-1	NK cell
ATCGATGTCTGGTGGC-1	CD4 T cell
ATCGGCGTCCATCTAT-1	Monocyte
ATCGTAGCACGCCAGT-1	Other
ATCGTAGTCTATCACT-1	B cell
ATCGTGAGTCGCTTGG-1	CD4 T cell
ATCTCTAAGGGTATAT-1	CD4 T cell
ATCTCTACATGCCATA-1	Monocyte
ATCTTCACAATTCGTG-1	Monocyte
ATGAAAGAGGTTAGTA-1	Monocyte
ATGAGTCTCTCGTGAA-1	NK cell
ATGCGATCATTGCCGG-1	Monocyte
ATGGAGGCATAATCGC-1	Monocyte
ATGGATCTCAGTGATC-1	Other
ATGGATCTCCTCATAT-1	Other
ATGGGAGCAATCTGCA-1	NK cell
ATGTCCCGTATCATGC-1	CD8 T cell
ATTACTCTCTTCCTAA-1	B cell
ATTCACTAGTGAGGTC-1	CD4 T cell
ATTCAGGAGCCATTCA-1	Monocyte
ATTCATCCAGGGTCTC-1	Monocyte
ATTCATCTCATCTGTT-1	Monocyte
ATTCATCTCCGTGCGA-1	Monocyte
ATTCCATCACGAGGAT-1	B cell
ATTCCCGAGACCAAGC-1	Monocyte
ATTCCTATCAAGTGTC-1	Monocyte
ATTCGTTTCCACCCTA-1	Monocyte
ATTCGTTTCCTCTAGC-1	NK cell
ATTGGGTGTACATTGC-1	CD4 T cell
CAAAGAATCCTCTCGA-1	CD8 T cell
CAACAGTCAGTGAGCA-1	Other
CAACAGTTCCTGTAAG-1	Monocyte
CAACCAAGTCATCGCG-1	Dendritic cell
CAACGATAGCTACTAC-1	Monocyte
CAACGATCAGGTTCAT-1	Other
CAACGGCAGGATGGCT-1	Monocyte
CAACGGCTCAGGCGAA-1	CD4 T cell
CAATCGATCCACAGGC-1	Monocyte
CACATGATCGCTGTCT-1	Monocyte
CACCAAAAGGACAACC-1	Monocyte
CACCAAATCGGAGATG-1	Monocyte
CACCGTTAGGCTATCT-1	Monocyte
CACTGAACAGAAGCTG-1	Monocyte
CACTGAATCACACGAT-1	CD4 T cell
CACTTCGAGCAAGCCA-1	Monocyte
CACTTCGCATAGACTC-1	CD4 T cell
CAGAGCCCAATTTCCT-1	Monocyte
CAGATACAGAATCGAT-1	B cell
CAGATACCACGGGCTT-1	Monocyte
CAGATTGAGCCTTTGA-1	B cell
CAGCAGCTCACTGATG-1	CD8 T cell
CAGCAGCTCCTCACGT-1	Monocyte
CAGGCCAAGTGCCGAA-1	B cell
CAGGCCATCGTCGACG-1	NK cell
CAGGCCATCGTTCGCT-1	CD8 T cell
CAGGGCTCACGTAGTT-1	CD4 T cell
CAGGTATTCAGAGCAG-1	CD8 T cell
CAGTTAGAGGTCGAGT-1	Monocyte
CAGTTAGGTAGCGTCC-1	CD4 T cell
CATAAGCCATGTTCAG-1	Other
CATAGACTCAACTGAC-1	CD8 T cell
CATCAAGAGCAGGTCA-1	CD4 T cell
CATCAAGAGCGTCTCG-1	B cell
CATCAAGAGGCCGCTT-1	Monocyte
CATCAAGCAGGCATTT-1	Monocyte
CATCCACTCTACGGGC-1	Monocyte
CATCCCAAGCACCCAC-1	Other
CATCCCAAGTCGGGAT-1	Other
CATCCCACACAAGGTG-1	B cell
CATCCCATCTACACTT-1	NK cell
CATCGCTCACTGAATC-1	Other
CATGCAAAGCGGACAT-1	Other
CATGCAAGTCCTGTTC-1	CD4 T cell
CATGCAAGTTAAGCAA-1	B cell
CATGCGGCATTCTCTA-1	Other
CATGGATAGCATCAGG-1	Other
CATGGATGTCTGTGCG-1	CD8 T cell
CATGGATTCGCAACAT-1	Other
CATGGTAGTTTCGTTT-1	Monocyte
CATTGCCAGCTAGCCC-1	Dendritic cell
CATTGCCAGTTAGTGA-1	Monocyte
CCAATTTTCGCTCTAC-1	CD4 T cell
CCACAAAGTCCAAGAG-1	Monocyte
CCACACTTCTATCGTT-1	Monocyte
CCACGAGGTGCCCAGT-1	Monocyte
CCATAAGGTGGCAACA-1	CD4 T cell
CCATAAGTCAATCTCT-1	Monocyte
CCCAACTGTATGAGCG-1	Monocyte
CCCAACTTCGTTCAGA-1	Monocyte
CCCATTGAGGAGGTTC-1	Other
CCCGGAAAGAAATTGC-1	CD4 T cell
CCCTCAAAGCTTTCCC-1	CD8 T cell
CCCTCAATCTGGGATT-1	Monocyte
CCCTCTCCAAGTTCCA-1	Monocyte
CCGAACGAGAAGTATC-1	Monocyte
CCGGTAGAGACTCTTG-1	CD8 T cell
CCGGTAGGTGACGTCC-1	CD4 T cell
CCTAACCAGAGCATAT-1	Other
CCTAAGAGTACGGTTT-1	Other
CCTACGTCACATATGC-1	Dendritic cell
CCTACGTTCACTGAAC-1	Monocyte
CCTATCGCACACCTAA-1	Monocyte
CCTCAACTCACAACCA-1	B cell
CCTCAACTCAGAACCT-1	CD8 T cell
CCTCCAATCCCTCGTA-1	Other
CCTCCTCTCCCATGGG-1	Other
CCTGCATTCGACCAAT-1	Monocyte
CCTGTTGGTGACTGAG-1	CD4 T cell
CCTTGTGTCCCTTCCC-1	Other
CCTTGTGTCTCCTGTG-1	CD8 T cell
CGAATTGGTCGAATTC-1	Monocyte
CGACAGCAGGAGCAAA-1	B cell
CGACAGCGTGGACCAA-1	Monocyte
CGAGAAGAGCATGCAG-1	Other
CGAGAAGCAGTCGGAA-1	B cell
CGAGAAGTCCGAACGC-1	CD4 T cell
CGAGGAACAGTCAGTT-1	B cell
CGAGGAAGTCGTACTA-1	CD8 T cell
CGAGGCTAGTCCGCGT-1	Other
CGAGGCTCACACGCCA-1	Monocyte
CGAGTGCCAGGCACTC-1	CD4 T cell
CGATCGGCAGCCTTCT-1	NK cell
CGATGCGAGCATCCTA-1	CD4 T cell
CGATGCGGTAAGGCCA-1	CD4 T cell
CGCAGGTCAAACTAGA-1	Monocyte
CGGACACCATCAGTGT-1	B cell
CGGAGAACACTATCCC-1	Monocyte
CGGGACTGTAAGTCAA-1	Monocyte
CGGGCATAGTACCATC-1	Monocyte
CGGGTCATCATTCATC-1	Monocyte
CGGGTGTCACTGGATT-1	Monocyte
CGGTCAGCAGTCGCAC-1	Monocyte
CGTAAGTAGGTCGTAG-1	CD8 T cell
CGTAGTAAGATGAACT-1	CD8 T cell
CGTCAAACATTGTGCA-1	CD4 T cell
CGTCAAATCGCAGTCG-1	CD4 T cell
CGTCCATAGCCATATC-1	Monocyte
CGTGTCTCAGCTTCGG-1	Other
CGTTAGAGTATGTGTC-1	CD8 T cell
CTAACTTGTTACAGCT-1	CD8 T cell
CTACATTCAGCATGCC-1	CD4 T cell
CTACCCAAGAGAGGTA-1	NK cell
CTACCCAGTCATGGCC-1	Monocyte
CTACCCATCATTTGGG-1	Other
CTACCTGAGGTTTGAA-1	CD8 T cell
CTACCTGTCAATCCGA-1	CD4 T cell
CTACGGGAGGGAGAAT-1	Monocyte
CTAGACAGTGCTGTCG-1	Other
CTAGACAGTTAACCTG-1	CD8 T cell
CTAGGTAAGCGAGTCA-1	Monocyte
CTAGGTATCAGTAGGG-1	Monocyte
CTATAGGTCAAATGAG-1	Monocyte
CTATCCGAGGAAAGAC-1	Monocyte
CTATCCGTCCCATACC-1	CD8 T cell
CTATCCGTCCGTTGGG-1	Monocyte
CTATCTACATGACGTT-1	Monocyte
CTCAACCAGCATGTTC-1	CD8 T cell
CTCAATTAGCCAAGGT-1	CD4 T cell
CTCAATTTCCAAGGGA-1	CD4 T cell
CTCAATTTCTTTCTAG-1	B cell
CTCAGAAAGGTAGATT-1	Monocyte
CTCAGAAGTCCTTTGC-1	CD4 T cell
CTCAGAAGTGTTTCTT-1	CD8 T cell
CTCAGTCAGTGATTCC-1	CD4 T cell
CTCAGTCTCACCCTTG-1	Other
CTCATCGAGAGCAGAA-1	CD8 T cell
CTCATCGAGGTTCTAC-1	NK cell
CTCATCGGTCGTATGT-1	Monocyte
CTCATGCGTGTTTCTT-1	CD4 T cell
CTCATGCTCACTTTGT-1	Monocyte
CTCCAACGTTCCGGTG-1	CD8 T cell
CTCCATGTCGCCTCTA-1	CD4 T cell
CTCCTCCGTTTCCCAC-1	Monocyte
CTCTCGAAGGATATAC-1	CD4 T cell
CTCTCGAGTGGACAGT-1	Monocyte
CTCTGGTGTGCCTTCT-1	Monocyte
CTCTGGTTCCGAGGCT-1	CD8 T cell
CTGATCCAGCGTATGG-1	B cell
CTGATCCCATCATCTT-1	CD8 T cell
CTGATCCTCCGATCTC-1	Monocyte
CTGCATCGTAACGATA-1	CD8 T cell
CTGCCTAAGAGTAACT-1	NK cell
CTGCTCAAGAGAGGGC-1	Other
CTGGCAGCATCCTCAC-1	CD8 T cell
CTGGTCTGTGCGGATA-1	CD4 T cell
CTGTACCCATTAAAGG-1	Monocyte
CTGTAGAGTTTGAAAG-1	Monocyte
CTGTATTCATGTGGCC-1	CD8 T cell
CTGTCGTAGGCACGAT-1	Other
CTTACCGAGTCGCGAA-1	Other
CTTAGGAGTTTCCAAG-1	B cell
CTTCCGAGTCCTCCAT-1	CD4 T cell
CTTCCTTCATGACGAG-1	CD8 T cell
CTTCCTTGTCTTTCAT-1	CD4 T cell
CTTCGGTGTTGCATTG-1	NK cell
CTTCTAACAGGGATAC-1	Monocyte
CTTCTAATCCGAAGGA-1	Other
CTTCTCTAGCCTGCCA-1	CD4 T cell
CTTGATTAGCAGAAAG-1	CD4 T cell
CTTTCAACAGCTCTGG-1	CD4 T cell
GAAACCTTCAGGAACG-1	Monocyte
GAAACCTTCGCAAGAG-1	Other
GAACGTTAGGAGAGTA-1	CD8 T cell
GAACTGTAGGGCAATC-1	Monocyte
GAAGCCCGTCATCACA-1	Monocyte
GAAGTAAGTCCTCATC-1	Monocyte
GAATAGACAATCTCTT-1	Monocyte
GAATCACGTTTATGCG-1	Monocyte
GAATCGTGTTTGGCTA-1	Monocyte
GAATCGTTCCAAACCA-1	NK cell
GACACGCAGGTCCCTG-1	Other
GACACGCGTGACGTCC-1	Monocyte
GACAGCCCATACTGAC-1	Monocyte
GACAGCCGTGTGTACT-1	Monocyte
GACCCTTTCACGGGCT-1	Monocyte
GACCGTGGTGCGTCGT-1	CD8 T cell
GACCTTCCATGGCTAT-1	Monocyte
GACGCTGAGAATCTAG-1	Monocyte
GACGCTGGTATCGTGT-1	Monocyte
GACTATGTCCGATTAG-1	CD4 T cell
GACTCAAAGAGTCTTC-1	Other
GACTCAAAGCTGACTT-1	CD4 T cell
GACTCAAGTCTTCCGT-1	CD4 T cell
GACTGATAGTCACGAG-1	CD4 T cell
GACTGATGTCTCTCAC-1	CD4 T cell
GACTTCCTCATGAGTC-1	B cell
GAGAAATAGAACCGCA-1	Monocyte
GAGACCCGTAGTTCCA-1	CD8 T cell
GAGAGGTGTCATATGC-1	Monocyte
GAGATGGCATGTTCAG-1	CD4 T cell
GAGCCTGAGCCTCTTC-1	NK cell
GAGGCAACATAACAGA-1	B cell
GAGGCAAGTAGGTACG-1	Monocyte
GAGGGATCAGAGCGTA-1	Monocyte
GAGGGTACAGCTGAAG-1	CD4 T cell
GAGGGTAGTACTGTTG-1	Other
GAGTCTACACTACACA-1	Monocyte
GAGTGTTCACGTACTA-1	B cell
GAGTGTTCAGTACTAC-1	Other
GAGTTTGTCGCGCTGA-1	CD8 T cell
GATAGCTAGACGCAGT-1	B cell
GATAGCTCATTCCTCG-1	CD8 T cell
GATCACAAGGACTGGT-1	CD4 T cell
GATCACAAGTCCCAGC-1	CD8 T cell
GATCACACAAAGAACT-1	Dendritic cell
GATCGTAGTATGTGTC-1	CD4 T cell
GATGACTGTTAGGGTG-1	CD8 T cell
GATTCGAGTGCGGCTT-1	CD4 T cell
GATTCGAGTGTTGACT-1	Monocyte
GATTCTTAGGAGTATT-1	Monocyte
GATTCTTGTGGCGTAA-1	Monocyte
GATTTCTAGTGTGTTC-1	Other
GCACTAATCTTCTCAA-1	Other
GCAGCCATCCGATGCG-1	Monocyte
GCAGCTGGTAGCTGCC-1	Monocyte
GCAGTTATCCGGTAAT-1	Other
GCATCTCGTCACTGAT-1	Monocyte
GCATGATCACATAACC-1	CD4 T cell
GCATGATGTTCTCACC-1	Monocyte
GCCAACGGTGGCGTAA-1	CD4 T cell
GCCAGTGGTCATAGTC-1	Other
GCCATGGAGCCATATC-1	Other
GCCATTCTCAATCGGT-1	Monocyte
GCCCAGAAGAAACCCG-1	CD8 T cell
GCCGATGTCTGCCTGT-1	Monocyte
GCCTGTTTCAAACCCA-1	Monocyte
GCGATCGGTGAGTCAG-1	Monocyte
GCGATCGGTGGAGGTT-1	CD8 T cell
GCTGGGTGTACGATTC-1	CD8 T cell
GCTTGGGCACCACTGG-1	CD8 T cell
GCTTGGGGTACGTACT-1	CD4 T cell
GGAACCCAGACATAGT-1	CD8 T cell
GGAGAACTCAGAATAG-1	Dendritic cell
GGAGCAATCCAACTGA-1	Other
GGAGCAATCGAGCACC-1	CD4 T cell
GGAGGATAGAGTCGAC-1	B cell
GGAGGATCAGCAGTCC-1	B cell
GGAGGATGTCTTGAGT-1	CD4 T cell
GGAGGTAGTAGGTGCA-1	Monocyte
GGATCTAGTGCCTTCT-1	Other
GGCAGTCGTCTGCGCA-1	NK cell
GGCGTCACACGGAAGT-1	CD8 T cell
GGCTGTGCAATACAGA-1	Monocyte
GGCTTGGAGTGATTCC-1	Monocyte
GGCTTTCTCGTGTGAT-1	Monocyte
GGGAAGTTCCACAGCG-1	Monocyte
GGGACAATCTGGTTGA-1	CD8 T cell
GGGAGATGTGCAGTGA-1	B cell
GGGCGTTCATTCTCTA-1	CD4 T cell
GGGCTACGTCTTAGTG-1	Monocyte
GGGTATTAGCGTGCTC-1	CD4 T cell
GGGTATTGTATAATGG-1	NK cell
GGGTCACAGCTACAAA-1	CD8 T cell
GGGTCACGTGACAGCA-1	Other
GGGTGAATCTCTGACC-1	CD4 T cell
GGGTTATTCATAAGGA-1	CD8 T cell
GGTAATCAGGATATAC-1	Monocyte
GGTCACGGTTGAGGAC-1	Monocyte
GGTCTGGGTCTACAAC-1	CD8 T cell
GGTGAAGGTCTGATAC-1	Dendritic cell
GGTGATTCAAGCACAG-1	B cell
GGTGATTCACAGCTTA-1	NK cell
GGTGATTTCAGTCTTT-1	Monocyte
GGTGGCTAGTTAACAG-1	Monocyte
GGTGTCGAGGTTATAG-1	CD4 T cell
GGTGTTACAACTTGGT-1	Other
GGTGTTACAATCGCGC-1	CD4 T cell
GGTGTTATCCTGTAGA-1	Other
GTAACCACATTGACCA-1	CD4 T cell
GTAATCGGTACCGGAA-1	Monocyte
GTAATGCCAAGTAGTA-1	CD8 T cell
GTACAGTAGATAACGT-1	CD4 T cell
GTAGAAATCAGACCCG-1	Other
GTAGAGGAGCATCCCG-1	CD4 T cell
GTAGATCAGCCGATAG-1	CD8 T cell
GTAGATCAGTGGTGGT-1	B cell
GTAGATCTCGTCAACA-1	Monocyte
GTAGGAGAGCGACTAG-1	B cell
GTAGTACTCGCCATAA-1	Monocyte
GTATTGGAGTATGATG-1	Monocyte
GTATTGGTCAGGAACG-1	B cell
GTCAAACAGCCAGAGT-1	CD4 T cell
GTCAAGTCAATTAGGA-1	Other
GTCACGGCACATACGT-1	CD4 T cell
GTCACGGGTGCCTGAC-1	Other
GTCACGGTCATCGCCT-1	B cell
GTCATCCGTGCAATGG-1	Monocyte
GTCCACTCACCACTGG-1	Monocyte
GTCGAATGTAGTACGG-1	Monocyte
GTCGAATGTATACCTG-1	NK cell
GTCGAATTCCGACGGT-1	CD8 T cell
GTCGTTCGTCATCAGT-1	Dendritic cell
GTCTACCGTTAACAGA-1	CD4 T cell
GTCTAGAGTGTCACAT-1	Other
GTCTCACAGACCTCAT-1	B cell
GTCTGTCAGAGTTGTA-1	CD8 T cell
GTCTGTCGTTGCATAC-1	Monocyte
GTCTTTAGTGAGTTGG-1	CD8 T cell
GTGACGCTCCAAAGGG-1	B cell
GTGAGGAGTTGGGCCT-1	CD8 T cell
GTGAGTTTCTTGAGCA-1	Monocyte
GTGCACGGTAAGCGGT-1	Other
GTGCAGCCAATGTTGC-1	CD4 T cell
GTGCGTGAGGAATTAC-1	Other
GTGCTTCAGCCTGCCA-1	B cell
GTGGAAGAGACCAGAC-1	CD4 T cell
GTGTGGCCATGCCGCA-1	CD4 T cell
GTGTTAGAGCGTGCTC-1	Other
GTGTTCCAGCTGGCCT-1	CD8 T cell
GTTAGACGTCACTCGG-1	CD4 T cell
GTTAGACGTGCTGCAC-1	CD8 T cell
GTTCATTTCCTGTTGC-1	Monocyte
GTTGCGGGTGAGACGT-1	CD4 T cell
GTTGCGGTCATTTACC-1	CD8 T cell
TAACACGCAAGTTCCA-1	Monocyte
TAACCAGAGAAGAGCA-1	Other
TAACTTCTCGCAAGAG-1	Other
TAAGCACAGCGCCTCA-1	Other
TAAGCACAGTGTACCT-1	B cell
TAAGCACCAACATCGT-1	CD8 T cell
TAAGCGTGTGATGGCA-1	Monocyte
TAATTCCGTGCAATGG-1	B cell
TACAACGTCGATCCCT-1	CD4 T cell
TACACCCTCCCATGGG-1	Monocyte
TACAGGTAGTGTCATC-1	Monocyte
TACCGAAGTACTAAGA-1	B cell
TACCTCGGTGGGCTCT-1	Monocyte
TACGCTCAGGTCTTTG-1	Other
TACGCTCCACTTGGCG-1	CD4 T cell
TACGCTCTCTTCCCAG-1	CD8 T cell
TACGGGCGTCCCTGTT-1	CD4 T cell
TACGGGCTCCTGATAG-1	Other
TACTTACCAGAGTTCT-1	B cell
TAGACCACACCAGACC-1	CD8 T cell
TAGACCATCCGGTAGC-1	Monocyte
TAGACTGCAGCGCTTG-1	Monocyte
TAGACTGCATCTTTCA-1	Monocyte
TAGAGTCAGGACAGTC-1	B cell
TAGAGTCGTCTTGAGT-1	NK cell
TAGATCGCAAGAGAGA-1	Other
TAGGAGGTCCTACCGT-1	CD4 T cell
TAGGGTTAGTGTTGAA-1	Other
TAGGTACTCACCATGA-1	CD4 T cell
TAGTGCACATTCAGCA-1	Monocyte
TATATCCCAGCGGATA-1	B cell
TATCGCCCAGGACAGT-1	B cell
TATGTTCAGGATTACA-1	CD4 T cell
TATTGCTCACGCCACA-1	Monocyte
TCAAGACAGCACTGGA-1	B cell
TCAAGACTCTACAGGT-1	Monocyte
TCAAGCAGTTGCCATA-1	CD4 T cell
TCAATTCTCCGCACGA-1	CD8 T cell
TCACAAGGTTCAGTAC-1	CD4 T cell
TCACACCGTTGTTGCA-1	Monocyte
TCACGCTGTACGATCT-1	CD8 T cell
TCACGCTTCTTTGCTA-1	CD4 T cell
TCACGGGAGCGTTCCG-1	B cell
TCACGGGGTACGAGTG-1	B cell
TCACGGGTCTCTGAGA-1	Other
TCACTATAGACATATG-1	Monocyte
TCACTATCATCGAACT-1	Other
TCACTCGAGTCAATCC-1	CD4 T cell
TCACTCGCACTGTGAT-1	Monocyte
TCAGCAACAGAGGACT-1	Other
TCAGGTAGTCTCTCTG-1	Monocyte
TCAGTTTCACATATGC-1	Monocyte
TCAGTTTCAGAGTCAG-1	Monocyte
TCATACTTCAGTGTCA-1	Monocyte
TCATCATGTGAGTTTC-1	Monocyte
TCATCATTCCGCGAGT-1	Other
TCATGAGAGGCAGGTT-1	B cell
TCATGAGGTGTCATCA-1	Monocyte
TCATGCCCAGGGAATC-1	CD4 T cell
TCATGGACATAGAAAC-1	Dendritic cell
TCATGTTCATCGGAGA-1	Monocyte
TCATTCAGTCGAACGA-1	Monocyte
TCATTTGTCACTACGA-1	B cell
TCCACGTGTCACGCTG-1	Other
TCCACGTGTTAAGGAT-1	Monocyte
TCCACGTGTTTATGCG-1	CD4 T cell
TCCAGAATCTGAGCAT-1	CD8 T cell
TCCATCGCAATTGTGC-1	CD8 T cell
TCCATGCCAAAGGTTA-1	CD4 T cell
TCCCACAGTTATCTGG-1	CD8 T cell
TCCCACATCGAACCAT-1	NK cell
TCCCAGTCAGTAGTTC-1	Monocyte
TCCCAGTTCATCACTT-1	Other
TCCCATGCAGAACTTC-1	Monocyte
TCCGTGTTCTCAACGA-1	Monocyte
TCCTCTTTCCACAGCG-1	CD8 T cell
TCCTTCTTCGTTATCT-1	Other
TCGAACACAATCCAGT-1	Monocyte
TCGAACAGTCGCATTA-1	Other
TCGAAGTAGAACGTGC-1	Monocyte
TCGAAGTGTCAGACGA-1	CD4 T cell
TCGACCTGTATTGAGA-1	CD4 T cell
TCGCTCAAGTTGGAAT-1	Monocyte
TCGCTTGTCTGTGCAA-1	Monocyte
TCGGGACAGCAGGGAG-1	CD4 T cell
TCGGGCATCAAATGAG-1	CD8 T cell
TCGGTCTTCTGAACGT-1	CD8 T cell
TCGTAGAAGGAGTCTG-1	B cell
TCTACATCAAAGGATT-1	Monocyte
TCTACCGCAACGTATC-1	CD4 T cell
TCTACCGGTTGTACGT-1	CD8 T cell
TCTATACGTAATGATG-1	Monocyte
TCTATACTCTACAGGT-1	CD8 T cell
TCTATCACAACAAAGT-1	Monocyte
TCTCACGAGACACACG-1	CD4 T cell
TCTCACGAGCCAGACA-1	Monocyte
TCTCACGGTGCGTTTA-1	CD8 T cell
TCTCCGACACAGGATG-1	CD8 T cell
TCTCCGAGTGAGTTGG-1	Monocyte
TCTCCGAGTGGAATGC-1	Monocyte
TCTCCGATCAACCCGG-1	Other
TCTGCCATCTCTGACC-1	Monocyte
TCTGTCGCAGACCGCT-1	CD4 T cell
TCTTAGTAGGGAGTGG-1	Monocyte
TCTTAGTCAAGACCGA-1	Monocyte
TCTTAGTTCCATACTT-1	CD4 T cell
TCTTCCTGTAAGATTG-1	B cell
TCTTCCTTCTCGCAGG-1	Monocyte
TCTTTGATCATTGCCC-1	Other
TGACCCTGTTCGTTCC-1	Monocyte
TGACGCGTCTCCCTAG-1	CD8 T cell
TGACTCCAGTCGGCAA-1	B cell
TGAGACTAGTGGAAAG-1	CD4 T cell
TGAGACTCAAGGCGTA-1	Monocyte
TGAGCATTCTCATTTG-1	Other
TGAGCGCGTGGATGAC-1	CD8 T cell
TGAGGTTCACCCGTAG-1	CD4 T cell
TGAGGTTCACCCTAAA-1	CD8 T cell
TGAGGTTTCCCAGGAC-1	Monocyte
TGAGTCAAGCGACTGA-1	B cell
TGAGTCAAGGTGCTAG-1	Monocyte
TGATGCAAGTCTGCAT-1	Other
TGATTCTAGAAGCGCT-1	Monocyte
TGATTCTGTTTGGCTA-1	NK cell
TGCACGGAGAGTGAAG-1	CD4 T cell
TGCACGGCAGGATGAC-1	CD8 T cell
TGCAGATAGACGTCGA-1	B cell
TGCAGGCTCCGTGTCT-1	Monocyte
TGCATCCCAGGATGAC-1	CD4 T cell
TGCATGAGTGTAACGG-1	Monocyte
TGCGACGTCAGCGCGT-1	Monocyte
TGCGGCACACAACGAG-1	Monocyte
TGCTGAAGTGTACATC-1	CD8 T cell
TGCTTCGCAGGCACTC-1	CD8 T cell
TGCTTGCTCGATACTG-1	Monocyte
TGGAACTTCTGTTCAT-1	NK cell
TGGATCAGTCTGTCCT-1	B cell
TGGATCAGTTCCACGG-1	CD4 T cell
TGGATGTAGCGACATG-1	Dendritic cell
TGGGAAGAGTCACGAG-1	Monocyte
TGGGAGACATGTGGTT-1	Monocyte
TGGGAGAGTAACATGA-1	Monocyte
TGGGAGATCATGGAGG-1	CD8 T cell
TGGGAGATCGCCTCTA-1	NK cell
TGGGCGTCAGCTACAT-1	Monocyte
TGGGCTGTCTCACGAA-1	Other
TGGGTTATCCCAGTGG-1	CD4 T cell
TGGTGATGTTGCGTAT-1	Monocyte
TGGTTAGAGGATAATC-1	B cell
TGTCCCACAGCGTACC-1	Monocyte
TGTCCCATCATGGGAG-1	CD4 T cell
TGTGAGTAGCCTTTCC-1	CD4 T cell
TGTGAGTCATCAGTCA-1	Monocyte
TGTGATGAGAAGTCTA-1	B cell
TGTGGCGGTCGTTGGC-1	Other
TGTGTGAGTACTAAGA-1	B cell
TGTTACTAGTCTCGTA-1	Monocyte
TGTTACTTCACCTCTG-1	Monocyte
TGTTGAGAGCTGACTT-1	Monocyte
TGTTTGTCACGACGCT-1	CD4 T cell
TGTTTGTCATTCTGTT-1	Other
TGTTTGTTCTGGGCGT-1	CD4 T cell
TTAATCCTCTCGGCTT-1	Other
TTACAGGAGGATATGT-1	B cell
TTACAGGTCTATACGG-1	CD4 T cell
TTACCGCGTGGACTAG-1	B cell
TTACTGTCAACCTATG-1	Dendritic cell
TTACTGTGTTGGGTAG-1	CD4 T cell
TTAGGCAAGACATCCT-1	Monocyte
TTAGGCAGTACTGCGC-1	CD4 T cell
TTAGGGTAGCTGTGCC-1	CD4 T cell
TTCAATCCACTGCACG-1	NK cell
TTCAATCTCCTCAGAA-1	Other
TTCACCGTCGACCAAT-1	Monocyte
TTCACGCCATGGCCCA-1	Other
TTCATGTAGGATACAT-1	Other
TTCATGTAGGCTCACC-1	Monocyte
TTCATGTCAGGACTTT-1	Other
TTCATTGAGAAGGCTC-1	Other
TTCATTGGTCGAGTGA-1	Monocyte
TTCCACGCATCCAATG-1	CD8 T cell
TTCCGTGCACAAGCCC-1	Monocyte
TTCCGTGTCTAGGCAT-1	CD4 T cell
TTCCTAACAATAGGGC-1	Monocyte
TTCCTTCAGAGTATAC-1	Other
TTCCTTCGTCATAGTC-1	CD4 T cell
TTCGATTTCCGTTGAA-1	Monocyte
TTCTAACGTGTTCGAT-1	B cell
TTCTAACTCCGAGTGC-1	B cell
TTCTCTCGTTCAAAGA-1	Monocyte
TTCTGTAAGCATAGGC-1	Other
TTCTGTACATAATGAG-1	Monocyte
TTCTTGACATATGAAG-1	Other
TTCTTGATCTCCGCAT-1	B cell
TTGAACGCATCCCGTT-1	Monocyte
TTGAACGTCTTCCGTG-1	NK cell
TTGACCCAGTAATACG-1	Other
TTGAGTGGTCCAGAAG-1	Monocyte
TTGATGGTCCGGTAGC-1	CD4 T cell
TTGCATTTCGCTAGCG-1	Monocyte
TTGCCTGAGAAGGTAG-1	Other
TTGCTGCAGGTCTGGA-1	Monocyte
TTGCTGCCAGTATGAA-1	NK cell
TTGCTGCTCTGGGAGA-1	Monocyte
TTGGATGGTAAGGCTG-1	CD4 T cell
TTGGATGTCGCCACTT-1	Monocyte
TTGGGATAGGCTTAGG-1	CD4 T cell
TTGGGATCATAATGCC-1	Other
TTGGGTACATCGAACT-1	Other
TTGGGTAGTGCCTTCT-1	NK cell
TTGTGGAAGCTCTGTA-1	CD8 T cell
TTGTGGATCCTAGCTC-1	Other
TTGTTGTAGTCATCGT-1	B cell
TTGTTTGCATCGCCTT-1	CD8 T cell
TTTACCACAGTAGTGG-1	CD8 T cell
TTTACGTGTAATGCTC-1	Other
TTTACGTGTGGGATTG-1	Other
TTTACTGAGGTTGACG-1	CD4 T cell
TTTACTGCAGTTGGTT-1	B cell
TTTAGTCGTTTGACAC-1	B cell
TTTCACACAACGGCCT-1	B cell
TTTCAGTAGCAAGGAA-1	CD4 T cell
TTTCAGTGTGTTAGCT-1	Monocyte
TTTCATGAGAGGGCGA-1	CD4 T cell
TTTCATGCATCCGGTG-1	CD8 T cell
TTTCCTCGTCCCACGA-1	CD4 T cell
TTTCCTCTCGATTGAC-1	Monocyte
TTTCGATCAGGCATTT-1	CD4 T cell
TTTCGATGTCAACGCC-1	Other
TTTGACTTCTCCGAGG-1	Monocyte
TTTGATCCAAACCACT-1	Monocyte
TTTGGTTCACAAGTGG-1	B cell
